европейский: европейском европейского европейский европейское европейские европейская европейских европейской европейским европейскому
регион: регионе регион региона регионов регионы регионами региону регионах
зарегистрировать: зарегистрировано зарегистрированных зарегистрированы зарегистрированной зарегистрирован зарегистрировала зарегистрирована
сам: самое сами сама самих самом самому самой самим саму самого
большой: большое наибольшее наибольший большой большого наибольшей большому наибольшему
число: число числу числе числа числом
случай: случаев случае случаю случай случаях случаям случаи случая случаями
заболевание: заболевания заболеваний заболеваниям заболеваниями заболевание заболеванием
корь: корью кори корь
последний: последние последнюю последних последним последний последнее последнем последняя последнего
год: лет году годом года годах годами год годы годов
новость: новости новостей новость
оон: оон
перейти: перейти перейдя
основное: основному основном основным
содержаниюнавигации: содержаниюнавигации
добро: добро
пожаловать: пожаловать пожалуй
русский: русский русского русском
другой: другие других другими другим другому другого
глобальный: глобальный глобальной глобальным глобальному глобального глобальные глобальном глобальных глобальными глобальную глобальная глобальное
взгляд: взгляд взглядами взглядов
человеческий: человеческие человеческих человеческого человеческий человеческая человеческим
судьба: судьбы судьбой
поиск: поиск поисках поиска
расширить: расширенный расширить расширят расширены расширили расширенного
язык: язык языке языка языках
меню: меню
главный: главная главный главной главную
азия: азия азии азией
америка: америка америке америки
африка: африка африке африки африку африкой
ближний: ближний ближайшее ближнем ближайшие ближнего ближайшем ближнему
восток: восток востоке востока востоку
европа: европа европы европе европой европу
тема: темы теме темой тема тему
гуманитарный: гуманитарная гуманитарной гуманитарные гуманитарных гуманитарный гуманитарного гуманитарным гуманитарными гуманитарном гуманитарную
помощь: помощь помощи помощью
беженец: беженцы беженцам беженцев
мигрант: мигранты мигранта мигрантов
женщина: женщины женщин женщина женщине женщинам женщинах женщинами
здравоохранение: здравоохранение здравоохранения здравоохранению здравоохранении здравоохранением
климат: климат климата климатом климату
окружать: окружающая окружающую окружающей окружающих
среда: среда среды среду среде
культура: культура культурах культуре
образование: образование образования образовании образованию
международный: международное международного международной международный международная международным международными международных международную международному международные
правый: право права прав
мир: мир мире мира миру
безопасность: безопасность безопасности безопасностью
генеральный: генеральный генерального генеральная генеральной
секретарить: секретарь секретаря
человек: человека людей человек человеку люди людям людьми людях человеком
цель: цели целям целью цель целях
устойчивый: устойчивого устойчивые устойчивому устойчивой устойчивым устойчивых устойчивую устойчивыми
развитие: развития развитие развитии развитию развитием
экономический: экономическое экономическим экономическому экономической экономические экономических экономического экономическом экономический
подробный: подробнее
интервью: интервью
сюжет: сюжеты
экспрессновости: экспрессновости
фоторепортаж: фоторепортажи
пресссекретарь: пресссекретарь
выступление: выступления выступлении
заявление: заявления заявлении заявление заявлению
пресса: прессой
официальный: официальные официальных официальным
поездка: поездки поездками
медиаресурсы: медиаресурсы
фотография: фотографии
прессрелизы: прессрелизы
группа: группа групп группе группы группам группах группу группой
аккредитация: аккредитации
сми: сми
интернеттрансляция: интернеттрансляция
аудиотека: аудиотека
подписаться: подписаться
воз: воз
вакцинация: вакцинация вакцинации вакцинацией вакцинацию
являться: является являются являемся являющийся являющиеся
хороший: лучшей наилучшее лучших лучший лучшее хороших хорошего лучшем хорошем хорошее наилучшими лучшая хороший наилучшей наилучшую
защита: защитой защиты защите защиту защита
печать: печать
марта: марта марте март
согласно: согласно
анализ: анализу анализа анализ анализы анализов
провести: проведенному провести проведены провела провели проведенного проведенная провел проведен проведенном
всемирный: всемирной всемирная всемирный всемирного всемирным всемирному
организация: организацией организации организация организациями организаций организациям организациях
юнисеф: юнисеф
вдвое: вдвое
ранее: ранее
самый: самым самых самые самыми самый самая
высокий: высоким высокого высокие высоких выше высокий высокой высокая высоко высокому высокими высок высоком высока высочайших
показатель: показателем показатель показателям показателей показателях показатели показателя показателями
процент: процентов процент процента процентами процентах проценте
страна: странах стране стран страны странам страна страной странами страну
центральный: центральной центральных центральная центрального центральные
приходиться: приходится приходилась приходятся приходилось
ребенок: детей дети ребенка ребенок детям ребенку детьми ребенком
возраст: возрасте возраста возрастов возраст возрасту
пять: пяти пятью пять
половина: половины половина половину половине половиной
потребовать: потребовали
госпитализация: госпитализации госпитализаций госпитализацией госпитализациям
предварительный: предварительным предварительной предварительная предварительную предварительное
дать: данным данные данных данная данными данный дала дать дан дали дало данном
получить: полученным получили получить полученные получит полученной получившая полученный получивший получивших получившие получила полученных полученную получат получившим
состояние: состоянию состояние состояния состоянии
зафиксировать: зафиксировано зафиксированы зафиксировала зафиксирован
фатальный: фатальных фатальной
исход: исходов исход исходу исходы исхода исходам
около: около
тысяча: тысяч тысячи тысяча тысячам
заболеваемость: заболеваемость заболеваемости заболеваемостью
целый: целом целей целый целое целому целые
снижаться: снижается снижаются
достигнуть: достиг достигло достигла достичь достигли достигнет достигнут достигнуто достигнута достигнув
минимум: минимума минимум минимуму
затем: затем
произойти: произошел произошла произошло произошли произошедший
всплеск: всплеск всплески всплеску всплеска всплеске
снижение: снижения снижение снижению снижением снижении
охват: охвата охвату охвате охват
иммунизация: иммунизацией иммунизации иммунизацию иммунизация
время: время времен временем
пандемия: пандемии пандемией пандемия пандемий пандемиям пандемиями
вновь: вновь
значительно: значительно
возрасти: возросло возросла возросли возрасти
уровень: уровень уровне уровня уровнем уровни уровню уровней
многие: многих многие многим
вернуться: вернулся вернулась вернуться вернулись
допандемийным: допандемийным
повышать: повышает повышая повышать повышают
риск: риск риска риски риском рисков рискам риску рисками рисках риске
вспышка: вспышек вспышкой вспышки вспышках вспышка вспышку вспышке вспышкам вспышками
это: это этим этому
тревожный: тревожный тревожным тревожно тревожны тревожную тревожной тревожных
звонкий: звонок
предупредить: предупредил предупредила предупредили предупредить
ханс: ханс
клюге: клюге
директор: директор директора
региональный: регионального региональный региональная региональной региональное региональные региональным региональными региональном
бюро: бюро
должен: должны должна должен должно
позволить: позволить позволят позволит позволила позволили позволило
сдавать: сдавать
позиция: позиции позиций позициям
каждый: каждой каждые каждому каждый каждого каждая каждое каждую каждым каждом
нужно: нужно
активизировать: активизировать активизирует активизировали активизировала
усилие: усилия усилий усилиям усилиях усилию
недостаточно: недостаточно
вакцинировать: вакцинированных вакцинировать вакцинируют вакцинированы вакцинировано вакцинировали
сообщество: сообществ сообщества сообществом сообществами сообщество сообществам сообществах сообществе сообществу
вирус: вирус вирусов вируса вирусом вирусы вирусами вирусам вирусе
успокаиваться: успокаивается успокаиваются
треть: треть трети третью
полмиллиона: полмиллиона
первый: первую первый первой первая
доза: дозу доз дозы дозой
вакцина: вакцины вакцин вакцинах вакцинам вакцину вакцина вакциной вакцинами
против: против
рамка: рамках рамки рамок
плановый: плановой плановую плановые
румыния: румынии румыния
следовать: следует следовать
казахстан: казахстан казахстану казахстане казахстана
пробел: пробелы пробелами пробел пробелов
резкий: резко резкое
указывать: указывает указывают
сказать: сказала сказал сказали сказать
регина: регина
доминикис: доминикис
защитить: защитить защищено защищены
опасный: опасной опасным опасная опасных опасные опасного опасную опасный опасна опаснее
болезнь: болезни болезнями болезнь болезнью болезням
необходимо: необходимо
принять: принять принятым принял приняли приняла принятой принятые принят примет примут приняты принято принята приняв
срочный: срочные срочно срочным срочный срочной срочных срочном срочного
мера: меры мер мере мерам мера мерах мерой
включать: включая включает включавшую включают включать
инвестиция: инвестиции инвестиций инвестициям инвестициях
сфера: сферу сфере сфер сферы
заразный: заразных заразным
поражающий: поражающих
помимо: помимо
смерть: смерти смерть смертей смертью смертями
вызвать: вызванных вызванной вызвала вызванный вызвали вызвана вызван вызванным вызвано вызванного вызвать вызванную вызвал
осложнение: осложнениями осложнения осложнений осложнениям
пневмония: пневмонию пневмонии пневмония пневмонией
энцефалит: энцефалит
диарея: диарею диареи
обезвоживание: обезвоживание обезвоживания обезвоживанию
вызывать: вызывать вызывающих вызывает вызывающий вызывают вызываемых вызывающей вызывая вызываемое
долгосрочный: долгосрочные долгосрочного долгосрочной долгосрочное долгосрочных долгосрочным долгосрочную
такой: такие такое таких такому таким такими такого такая такую таком
слепота: слепота слепоту
также: также
нарушить: нарушить нарушили нарушены нарушила нарушен
работа: работу работой работа работ работе работы
иммунный: иммунной
система: системы системами систем систему система системе системам системах системой
стирать: стирая
память: память памяти
бороться: бороться борющегося борются борется
инфекция: инфекциями инфекции инфекций инфекция инфекцию инфекциям инфекцией
подписываться: подписывайтесь
наш: нашу наши нашей нашем нашего наших наш нашему нашими наша наше
рассылка: рассылку
загружать: загружайте
приложение: приложение приложения
мобильный: мобильных мобильные мобильной мобильная мобильное мобильным мобильными мобильного
устройство: устройств устройства
проигрывать: проигрывает
битва: битву
украина: украину украине украины украина украиной
женева: женеве
обсуждать: обсуждают обсуждаем обсуждать обсуждает
вопрос: вопросы вопросов вопрос вопросам вопросах вопросами вопросу вопросом вопросе
ресурс: ресурсы ресурсов ресурсами
информация: информация информации информацию информацией
партнер: партнеров партнеры партнерами партнера партнером партнерам
новостной: новостные
анонс: анонсы
журнал: журнал журнале
отчет: отчеты отчете отчета отчету отчет
заседание: заседаниях заседании
аудиовизуальный: аудиовизуальные
материал: материалы материала материалов материалами материал материале материалом
общение: общение общения
твиттер: твиттер
главное: главные главных главное главным главными
брифинг: брифингов брифинг брифинге
стенограмма: стенограммы
комментарий: комментарии
журналист: журналистов журналистам журналисты журналистами
интернет: интернете интернета
фейсбук: фейсбук
вконтакте: вконтакте
контакт: контакты контакте контактов контакт
пользоваться: пользоваться пользовались пользуются пользуйтесь
сайт: сайтом сайтов сайте
указатель: указатель
часто: часто
задавать: задаваемые задают задаваемых
остерегаться: остерегайтесь
мошенничество: мошенничества
конфиденциальность: конфиденциальность конфиденциальности
условие: условия условиях условий условии условиям условием
пользование: пользования
пожертвование: пожертвования пожертвований
благодаря: благодаря
конвенция: конвенции конвенция конвенцию конвенцией
табак: табака табаком табак
удаться: удалось удастся
спасти: спасти спасены спасем спасли
миллион: миллионы миллионам миллионов миллион миллиона миллиону млн
жизнь: жизней жизни жизнь жизнью
фото: фото
архив: архива архив
употребление: употребление употребления употреблением
один: одним одной одни одного одна одно одну одними одном одному
основной: основных основные основная основными основной основную
фактор: факторов фактором факторы фактора
неинфекционный: неинфекционных неинфекционным неинфекционными неинфекционные
преждевременный: преждевременную преждевременных преждевременной преждевременные
февраль: февраля феврале февраль
десятилетие: десятилетия десятилетий десятилетиями десятилетие
табачный: табачных табачные табачной табачная
изделие: изделий изделия изделиям
снизиться: снизилось снизился снизились снизилась снизится
сообщать: сообщают сообщали
напоминать: напоминают напоминает напоминаем напоминать
важный: важнейшую важная важную важно важные важной важнейших важна важнейшие важными важных важнейшим важным важны важное
роль: роль роли
сыграть: сыграла сыграл
рамочный: рамочная рамочную
борьба: борьбе борьбу борьбы борьба
неделя: неделе неделю недель неделя недели
исполняться: исполняется
момент: момента момент моменте моментах
вступление: вступления
сила: силу силы сил силами силах сила
история: истории история историю
договор: договор договора
область: области область областях областей
общественный: общественного общественных общественному общественной общественными общественные
заключенный: заключенный
эгида: эгидой
сторона: сторонами сторонам стороны стороне
государство: государств государствами государства государствам государствах
который: которых которые которая который котором которой которое которыми которым которую которого которому
проживать: проживает проживают проживающего проживающих проживало
житель: жителей жителям жители
планет: планеты планете
представлять: представляет представляют представляющие представляющими представлять
себя: собой
правовой: правовую правовой правовых правовые
основа: основу основе основы основой основа
комплексный: комплексный комплексная комплексном комплексное комплексных комплексному комплексной комплексного комплексные
пакет: пакет
помочь: помогли поможет помогло помочь помогла помог помогут
среди: среди
закон: законы законов закона закон
запрещать: запрещающие запрещает запрещают
курение: курение курению курения курением
место: местах месте места мест место местом местам месту
введение: введение введению введения введением
повышенный: повышенных повышенного повышенная повышенный повышенной
налоговый: налогов
использование: использование использования использованию использовании использованием
графический: графических графические
предупреждение: предупреждений предупреждения предупреждении предупреждению
вред: вреде вред вреда
здоровье: здоровья здоровье здоровью здоровьем
пачка: пачках
сигарета: сигарет сигареты сигаретам
чума: чума
человечество: человечества человечество
причина: причина причиной причин причины причинам причинами
болезный: болезней
все: всем всеми всему
предотвратить: предотвратить
тедрос: тедрос
адханом: адханом
гебрейесус: гебрейесус
веха: веха вехи веху
продолжать: продолжаем продолжает продолжать продолжали продолжают
призывать: призывать призывает призывают призываем призывая призываю призывал
дальнейший: дальнейшему дальнейшего дальнейшие дальнейших
усиление: усилению усиления усиление усилении усилением
внедрение: внедрению внедрение внедрения
предложить: предложенных предложило предложена
добавить: добавил добавила добавили добавив добавить добавлены
призвать: призвал призвала призвали призвана призван призваны призванные призвано призвав призванной
ратифицировать: ратифицировали ратифицировала
сделать: сделать сделала сделало сделали сделает сделав сделаем
скорый: скорее скорой скором
сегодня: сегодня
коло: коло
миллиард: млрд миллиардов миллиарда миллиард
находиться: находятся находящиеся находился находится находящихся находиться находилась находились
крайний: крайней крайняя
предусмотренный: предусмотренных предусмотренная
требовать: требуют требовали требующая требует требующие требовать
размещать: размещать
крупный: крупные крупнейшим крупнейших крупным крупного крупных
десятка: десятки десяткам десятках
ввести: ввели введено введена ввести введены
требование: требование требованием требования
компания: компаний компании компанией компания
продавать: продавать продаваемых
простоять: простой
упаковка: упаковке упаковках
брендинга: брендинга
дизайн: дизайна
логотип: логотипа
читать: читайте
представить: представило представили представленные представленной представила представить представят представьте представлены
обновить: обновленные обновленную обновленная
четверть: четверти четверть
население: населения населением населению население
настоящее: настоящее настоящие
политика: политикой
бездымный: бездымной
запрет: запрета запреты запрете запрет
помещение: помещениях помещений помещения помещении
реклама: рекламу реклама рекламой
продвижение: продвижение продвижения продвижению
установление: установлении установление
лицо: лицом лиц лица лицам лицами лице
агрессивный: агрессивных агрессивными агрессивной агрессивного
кампания: кампаний кампания кампании кампанию кампаниями
промышленность: промышленности промышленность
тратить: тратит
доллар: долларов
свой: своей свой своя
продукция: продукции продукцию продукция продукцией
активно: активно
подрывать: подрывает подрывая подрывают
губительный: губительная
отрасль: отрасль отрасли отраслей
стоить: стоящая стоят стоит стоила
эпидемия: эпидемией эпидемии эпидемия
пытаться: пытается пытаются пытаемся
позиционировать: позиционировать
часть: часть частью частей частях
решение: решения решению решение решений решении решением решениях
мочь: могли могут могло можем могу могла мог можете
адриана: адриана
бланко: бланко
маркизо: маркизо
глава: глава главы главу
секретариат: секретариата секретариате
предоставлять: предоставляет предоставляя предоставляющие предоставлять предоставляют предоставляли предоставляемым предоставляемых предоставлявшие
комплекс: комплекс
постоянно: постоянно
меняться: меняющейся меняющаяся
тактика: тактики
направить: направленной направит направленный направленную направила направленные направленных направлена направленного направленное направлены направят направлен
получение: получение получения получением
прибыть: прибыли прибудут
счет: счет счете счета
инвалидность: инвалидность инвалидностью инвалидности
очередь: очередь очередях очереди
оборачиваться: оборачивается
огромный: огромными огромные огромное огромных огромную огромный огромна огромным огромному огромной
расход: расходами расходы расходов расходам расходах
выращивание: выращивание выращивания
отводиться: отводятся отводится
больший: большие большему большую больших большего больший большая большей большее большем
площадь: площади
противный: противном
использоваться: использоваться использовалась используются используется использовался
производство: производства производство производством
продовольствие: продовольствия продовольствию продовольствие
триллион: триллионы триллиона
окурок: окурков
загрязнять: загрязняют
менее: менее
охотно: охотно
отказываться: отказываются отказываться
мужчина: мужчины мужчин мужчина мужчинами
решать: решай решать
бросать: бросай
новый: новая новой новых новые новый новую новом новейшим новое нового новыми новым нова новому
бросить: бросить
курить: курить курит
чрезвычайный: чрезвычайных чрезвычайным чрезвычайные чрезвычайного чрезвычайный чрезвычайными чрезвычайной чрезвычайно чрезвычайная чрезвычайную
ситуация: ситуаций ситуациям ситуациях ситуацию ситуации ситуация ситуациями ситуацией
возрастать: возрастает
сколько: сколько
украинец: украинцев украинцам
эскалация: эскалация эскалации эскалацию эскалацией
конфликт: конфликтов конфликт конфликта конфликты конфликтом конфликтах конфликте конфликтами
природный: природные природного
бедствие: бедствия
приводить: приводят приводить приводя приводит приводящего приводили приводящих
рост: росту росте рост ростом роста
потребность: потребностей потребность потребностям потребностями потребности потребностью потребностях
пациент: пациентов пациент пациенты пациентам пациента пациентами
газ: газы газе газа газу газов
эвакуировать: эвакуированы эвакуировать эвакуируют
оаэ: оаэ
август: августа августе августу
короткий: короткий короткое короткие
период: период периода периодов
временить: времени
обнаружить: обнаружен обнаружены обнаружена обнаружили обнаруженным
полиовирус: полиовирус
несколько: нескольких несколько нескольким
военный: военных военной военное военными военного военные
угроза: угроз угрозами угрозой угроза угрозу угрозы угрозах угрозе
северный: северном северного северной северное северную северные северных северная
дарфуре: дарфуре
судан: судане суданом судан судану судана
подтвердить: подтвержден подтверждены подтвержденным подтвердив подтвердил подтвердила подтвердили подтверждено подтвержденных подтвердить подтверждена подтвержденные подтвержденном подтвержденными
массовый: массовый массовому массовая массовое массовых массовой массовые массовую массовыми
голод: голод голоду голода
повсеместно: повсеместно
наблюдаться: наблюдалось наблюдались наблюдается наблюдаются наблюдалась наблюдаться
расти: растущее растет росли расти растут растущую растущей
воздействие: воздействие воздействию воздействия воздействием воздействии
изменение: изменения изменением изменение изменений изменениям изменениями изменении изменению
частность: частности
волна: волн волны волнами волна волнах волне
жары: жары
наводнение: наводнений наводнения наводнениями
восточный: восточного восточный восточной восточном восточная
средиземноморье: средиземноморья средиземноморье
ханан: ханан
балхи: балхи
воевать: воюющие
взять: взять возьмем взяли взяты возьмите
обязательство: обязательство обязательства обязательств обязательствах
полный: полной полному полное полном полного полная полным полный
безоговорочно: безоговорочно
уважать: уважать
неприкосновенность: неприкосновенность
медицинский: медицинской медицинских медицинское медицинские медицинскими медицинскую медицинского медицинская медицинским медицинскому медицинский медицинском
мы: нам нами
нужный: нужен нужна нужны
безусловный: безусловный
неограниченный: неограниченный
доступ: доступ доступа доступе доступом доступу
нуждаться: нуждается нуждающихся нуждающимся нуждаются нуждаться нуждающиеся нуждающемуся
деятельность: деятельность деятельности деятельностью
избавить: избавлена
политизация: политизации
нападки: нападок нападкам
заявить: заявила заявил заявив заявили
представительница: представительница представительницы
кризис: кризис кризисом кризисов кризису кризиса кризисами кризисе
сообщить: сообщила сообщили сообщил сообщивших сообщив
июль: июля июле июль июлем
оказать: оказала оказать оказав окажет
поддержка: поддержку поддержки поддержке поддержка поддержкой
эвакуация: эвакуации эвакуацией
сопровождать: сопровождающих
бельгия: бельгию бельгия
испания: испанию испании испания
объединить: объединенные объединенных объединенной объединенная объединены объединили
арабский: арабские арабском
эмират: эмираты
осложняться: осложняются
закрытие: закрытием закрытию
мая: мая мае
пограничный: пограничного пограничный пограничных
переход: перехода переход переходах
рафа: рафах
течение: течение течения течением
месяц: месяцев месяцы месяца месяц месяце месяцем
выступать: выступаем выступает выступая выступающая выступала
открытие: открытие открытии открытия
возможный: возможных возможными возможное возможен возможным возможной возможны возможную возможного
маршрут: маршрутов
кпп: кпп
каремшалом: каремшалом
египет: египет
иордания: иорданию иордании иордания
оттуда: оттуда
оставаться: остается оставаться остаются оставалась оставались оставайтесь оставалось
слово: словам слова слово словами слове
серьезный: серьезную серьезным серьезной серьезно серьезное серьезных серьезные серьезная серьезными серьезного серьезна
обеспокоенность: обеспокоенность обеспокоенности
обнаружение: обнаружение обнаружения
полиовируса: полиовируса
тип: типа типов
проба: пробах проб пробы
сотрудничать: сотрудничает сотрудничая сотрудничающая сотрудничаем
министерство: министерством министерства министерство министерству
анклав: анклава анклаве анклав анклаву
детская: детским детских детская детскими детской
фонд: фондом фонд фонда фонде
ряд: ряду ряда ряд рядом ряде
проведение: проведение проведения проведению проведении
полиомиелит: полиомиелита полиомиелит полиомиелиту полиомиелитом
успешный: успешного успешному успешно успешные успешным успешное успешных
осуществление: осуществления осуществлением осуществлению
этот: этих эта этими
прекращение: прекращение прекращения прекращению прекращении прекращением
огонь: огня огонь
подчеркнуть: подчеркнула подчеркнул подчеркнув подчеркнули подчеркнуть
связь: связи связь связях
направлять: направляет направляю направляя
ливан: ливан ливане ливана
эксперт: экспертов эксперты эксперт экспертам
предоставить: предоставила предоставить предоставленной предоставлено предоставит предоставило
оборудование: оборудование оборудования
больница: больниц больнице больницы больницу больница больницах больницам
оказывать: оказывать оказывает оказываем оказывают оказывал оказывали
услуга: услуги услуг услугам услугами услугах
пострадать: пострадавших пострадавшим пострадать пострадают пострадало пострадали пострадала пострадавшими
травма: травм травмы травмам травмами травма
ранение: ранений ранения ранениями
работать: работает работают работающих работать работаем работая работающие работал работающими работающая работающим работала
сирия: сирии сирия
иран: иране
создание: созданием создания создание созданию создании
план: планов плана планах планы плане план
действие: действий действие действия действиям действиями действиях действию
отметить: отметила отметил отметили отмечен отметив отметить
надеяться: надеемся
прийтись: пришлось пришлась пришлись пришелся придется
насилие: насилие насилия насилию насилии насилием
недавний: недавнему недавним недавних недавние недавнего недавняя
продолжаться: продолжающееся продолжаться продолжающаяся продолжается продолжающимся продолжающегося продолжающийся продолжаются продолжающиеся продолжающуюся продолжающихся продолжающейся
привести: привело привели привела привести привел приведут приведет
некоторые: некоторых некоторые некоторым
район: районах районам районы районе районов район
дарфура: дарфура
лагер: лагере
замзам: замзам
замзаме: замзаме
внутренний: внутренне внутреннего внутреннем внутренних внутренним
переместить: перемещенных перемещенные
обеспечить: обеспечить обеспечены обеспечена обеспечило обеспечен обеспеченных
путь: путями пути путь путей путях
граница: границы границ
прошлый: прошлой прошлого прошлом прошлых прошлую
смочь: смогла смогут сможет сможем смогу смогли сможете
доставить: доставить доставила доставлены доставили
медикамент: медикаменты медикаментов медикаментами медикаментам
южный: южный южной южное южные южных южная южного
дарфур: дарфур
однако: однако
наиболее: наиболее
уязвимый: уязвимым уязвимых уязвимы уязвимыми уязвимые
открыть: открыть открытому открыла открытая открыл открытым открыты
чад: чадом чад
прокурор: прокурор
муса: мус
виновный: виновные виновных
зверство: зверствах
быть: будут будь бывший буду будем будучи
привлечь: привлечены привлекло привлечь
ответственность: ответственности ответственность
всеять: всей
вынуждать: вынуждать вынуждает вынуждают
бежать: бежать бежавших бежали бегут бежал бежавшая
война: война войны войной войну
покинуть: покинули покинуть
свое: свои своих своего свое своими своем своему своим
дома: дома
осложнять: осложняют
проливной: проливные
дождь: дожди
перемещение: перемещению перемещение перемещения перемещений перемещением
доставка: доставку доставке доставки доставкой
систематический: систематическое систематических систематического
изнасилование: изнасилований
качество: качестве качества качество качеством
орудие: орудия
бесчеловечный: бесчеловечным
ужасать: ужасающим
аспект: аспектом аспекты аспектах аспектам аспектами
делать: делает делают делать делая делали делаем
проводить: проводит проводят проводить проводим проводимым
обучение: обучение обучения обучении
работник: работников работники работниками работника работникам работником работник
метод: методам методу методы методов метод метода методах
клинический: клинического клинических клинический
ведение: ведения
психосоциальной: психосоциальной
жертва: жертв жертвам жертвами жертвы жертвой
возможность: возможности возможностей возможность возможностями возможностью
направление: направления направлениям
специалист: специалистам специалист специалистов специалисты специалистами специалисту
климатический: климатические климатический климатического климатических
катастрофа: катастрофы катастроф катастрофа катастрофе
экстремальный: экстремальные экстремальных экстремальной экстремальная
погодный: погодные погодных
явление: явления явлением
шторм: штормы
потеря: потерям потери потерь потеря потере потерю
происшествие: происшествия
иметь: имеют имеет иметь имеющих имели имеющей имел
масштабный: масштабные масштабнее масштабная масштабных масштабной масштабное масштабным
последствие: последствия последствий последствиях последствиям последствиями
распространение: распространению распространения распространение распространении распространением
передаваться: передающихся передающиеся передается передающимся передавалась передаваться передающееся передающимися
вод: воду воде
инфекционный: инфекционных инфекционного инфекционные инфекционным
кроме: кроме
ухудшать: ухудшают ухудшая
наносить: наносят наносит наносимом
ущерб: ущерб ущербу ущерба ущербе
инфраструктура: инфраструктуре инфраструктуру инфраструктура инфраструктуры
нехватка: нехватке нехватка нехваткой нехватки нехватку
специализированный: специализированной специализированных специализированные специализированное специализированного
недавно: недавно
результат: результате результатов результат результаты результатом результату результатам
сильный: сильного сильно сильные сильная сильными сильное сильнее сильных сильную
афганистан: афганистане афганистан
погибнуть: погибли погибших погибло погибнуть
оперативно: оперативно
метрический: метрических
тонна: тонн
машина: машины машин машинах
мобилизовать: мобилизовала мобилизует мобилизовать
бригада: бригад бригады бригада бригадам бригадами
коронавирус: коронавируса коронавирусом коронавирусе коронавирус
бедный: бедных беднейших бедными беднейшие
требоваться: требуется требуются
холера: холеры холера холерой холере
мешать: мешают мешает
трудность: трудности трудностями трудностей трудностям трудностях
предупреждать: предупреждает предупреждают предупреждаемых
вариант: вариантов варианты вариант вариантом вариантах вариантами
олимпийский: олимпийских
игра: играх игры игр играм
париж: париже
заражение: заражения заражений заражение заражением заражении заражению
появиться: появиться появится появилась появился появившийся
тяжелый: тяжелые тяжелого тяжелый тяжелой тяжелых тяжелыми тяжело тяжелее тяжелая тяжелую
доступность: доступность доступности доступностью
существенно: существенно
ухудшиться: ухудшилась
поскольку: поскольку
сократиться: сократилось сократилась сократились
производитель: производителей производители производитель производителем
попрежнему: попрежнему
распространяться: распространяется распространяться распространяющимся распространяются
мария: мария марией
ван: ван
керкхове: керкхове
вторник: вторник
летний: летние летнего летний летняя летних летней
западный: западной западном западный западного
частить: части
тихоокеанский: тихоокеанского тихоокеанском тихоокеанских тихоокеанскому
мониторинг: мониторинга мониторинг мониторинге
показывать: показывают показывает показывая
положительный: положительных положительным положительное положительные
тест: тестов тесты тест теста тестам
превышать: превышает превышающему превышают
сточный: сточных
воды: вод воды водах
циркуляция: циркуляция циркуляции
реальность: реальности реальность реальностью
два: двух две двум
темп: темпы темпах темпами
полушарие: полушарии
нетипичный: нетипичны
респираторный: респираторных респираторного респираторные респираторными респираторный респираторное респираторным респираторная
обычно: обычно
активный: активны активному активных активном активнее активный активным активная активной
низкий: низких ниже низким низкого низкий низкие
температура: температурах температурами температура температуры температурой
независимо: независимо
заразиться: заразились заразиться
меньший: меньшей меньший меньшими меньшие
спортсмен: спортсменов спортсменами
штамм: штаммы штамма штаммов штаммах штаммом штамм
развиваться: развиваться развиваются развивались развивается
появление: появления появлению появлением появление появлении
потенциально: потенциально
оказаться: оказаться оказались оказавшиеся оказалось оказался окажутся оказалась оказавшихся
выявлять: выявляем выявляет выявляю выявлять
реагировать: реагировать реагирует реагируют
вмешательство: вмешательство вмешательства
несмотря: несмотря
отделение: отделения отделений отделение
интенсивный: интенсивной интенсивную интенсивных интенсивные
терапия: терапии терапия терапию
намного: намного
пик: пике пик
правительство: правительства правительством правительство правительствами правительств правительству правительствам
обеспечивать: обеспечивая обеспечивает обеспечивающих обеспечиваем обеспечивают обеспечивать
убедиться: убедиться
особенно: особенно
относиться: относитесь относятся относится относились относящиеся
спрос: спроса спрос
сравнение: сравнению сравнения сравнении сравнение
сей: сих
пора: пор
существовать: существует существуют существующие существующую существующих существующим существующего существующими существовали
выразить: выразила выразили выразил выразить
низок: низком
стать: станет стало стала стал стали стать стану ставший станут
крайне: крайне
назальный: назальные
стадий: стадии стадиях
разработка: разработки разработке разработок разработка разработку
снизить: снизить снизили снижена снизят
инфицирование: инфицирования
коронавиру: коронавиру
маловероятный: маловероятно
омикрон: омикрон
инициатива: инициативе инициативы инициатива инициативу инициатив инициативам
грипп: гриппа гриппу грипп гриппом
смешивать: смешивать
караван: караван каравана
грудной: грудного грудным грудное грудном грудному
вскармливание: вскармливания вскармливанием вскармливание вскармливании вскармливанию
молдова: молдове молдова молдовы
развенчивать: развенчивает
миф: мифы мифов миф
помогать: помогает помогать помогают помогающих помогая помогала помогал помогаем помогали
семья: семьям семей семьи семьей семья семье семьях
продвигать: продвигает продвигать
преимущество: преимущества преимуществах преимуществ
ежегодно: ежегодно
республика: республике республики республика республику республикой
отмечаться: отмечается отмечаются отмечалась
общенациональный: общенациональной
расширение: расширению расширения расширение расширении расширением
матерой: матерей
младенец: младенцев младенца младенцы
путешествовать: путешествует путешествуя путешествовал
проект: проект проекты проекте проекта
различный: различных различными различные различным
проследовать: проследует
город: города городе городом
бельцы: бельцы бельцов
кантемир: кантемир
леово: леову
столица: столицу столица
кишинев: кишинев кишиневе
дорога: дороге
организовать: организованы организовали организована организованных организованная
информационный: информационные информационных информационная информационную
мероприятие: мероприятия мероприятий мероприятием мероприятии мероприятиях мероприятиям мероприятиями
участвовать: участвуют участвую участвовать участвовали участвующие участвовавшие
беременная: беременные беременной беременных
мать: матери матерям мать
член: члены членах членов членами
представитель: представители представитель представителей представителя представителям представителями
очень: очень
благодарный: благодарна
пообщаться: пообщаться
мама: мамами мам мама мамы
ольга: ольга
матей: матей
жительница: жительница жительниц
прийти: пришла пришло придем придет
подготовка: подготовки подготовку подготовке подготовкой
роды: родам родов роды родах
вместе: вместе
развенчать: развенчали развенчать
большинство: большинство большинстве большинства
связанный: связанных связаны связана связано связанной связанную связанная связан связанными связанный связанные связанного связанным
питание: питанием питании питание питания питанию
полезный: полезным
занятие: занятием занятий занятия занятие
непосредственный: непосредственная непосредственную непосредственного непосредственном непосредственному непосредственной
польза: польза пользу пользе
подчеркивать: подчеркивают подчеркивает подчеркивая
начало: начало начала начале начал началах началом
любой: любого любое любом любым любыми любой любых любому
новорожденный: новорожденного
позитивно: позитивно
влиять: влияя влияют влияет влияющих влияющей влиять
реж: реже
страдать: страдают страдающие страдало страдал страдает страдать страдающих страдали страдала страдаю
избыточный: избыточным избыточная избыточный
весомый: весом
ожирение: ожирением ожирения
подверженный: подвержены подвержена
диабет: диабету диабетом диабет диабета
поздний: позднем позже
кормить: кормят кормящие
грудь: грудью груди
рак: рака раком рак раками раке
молочная: молочной
железа: железы
яичник: яичников яичниками
приносить: приносит приносить
благоприятный: благоприятное благоприятную
достижение: достижении достижениях достижений достижения достижением достижению достижение
например: например
оно: оно
содействовать: содействует содействовать содействуем
укрепление: укреплению укрепления укрепление укреплением укреплении
цур: цур
гендерный: гендерному гендерной гендерного гендерное гендерным гендерными гендерную
равенство: равенству равенство равенством
сокращение: сокращению сокращение сокращения сокращении сокращением
неравенство: неравенства неравенство
расширять: расширяя расширяет расширять расширяют
способствовать: способствуя способствует способствовать способствующих способствовали способствуют способствующую
финансовый: финансовой финансовыми финансовую финансовые финансовых финансовым финансового
независимость: независимости
инклюзивному: инклюзивному
доказать: доказанные доказать доказали доказано
исключительно: исключительно
лишь: лишь
шесть: шести шесть
питаться: питаются питаться
молоко: молоком молока молоке
настолько: настолько
обсуждение: обсуждению обсуждения обсуждениям
объединять: объединяют объединяющего объединяет
принимать: принимающих принимать принимает принимают принимающей принимал принимали
нормализация: нормализации
поощрение: поощрения поощрение
прилагать: прилагают
получать: получали получают получать получает получающих
жить: живут живущих живущие жить жили живет
клэр: клэр
фарранд: фарранд
душевный: душевные
встреча: встречи встреча встреч
ход: ходе
участник: участники участников участникам участник участниками
прослушать: прослушать
сессия: сессии сессия
посвященныепреимуществам: посвященныепреимуществам
совет: советы советах советом совете совета совет
распространить: распространенные распространенным распространенный распространенных распространен распространены распространенное
заблуждение: заблуждения заблуждение
будущее: будущими будущее будущего будущем будущим будущих будущему будущие
медсестра: медсестра медсестер медсестрой медсестры
галина: галина
бостан: бостан
рада: рада рады рад
видеть: видеть видит видела
коллега: коллег коллегами коллегам коллеги
приверженность: приверженность
узнать: узнать узнайте узнаем узнают узнала
исключительность: исключительности
продолжение: продолжении продолжением продолжение
новорожденная: новорожденных новорожденные
политик: политика политику политики политике политикам политиков политиками
эффективный: эффективную эффективных эффективной эффективные эффективного эффективнее эффективным эффективному эффективное эффективно эффективны эффективными
интеграция: интеграции интеграцию
принятие: принятие принятию принятия принятием принятии
продление: продление
оплачивать: оплачиваемого оплачиваю оплачивает оплачивают
отпуск: отпуска отпуск
беременность: беременности беременность беременностей
свод: свода
править: правил правила правило
сбыт: сбыта
заменитель: заменителей
регулировать: регулирующего регулирующие регулирует регулировать регулирующих
практик: практики практике практику практика практик
маркетинг: маркетинга маркетинг
они: ними ими
продукт: продуктов продукты продуктам продукта продукт продуктами
реализация: реализацию реализации реализация
шаг: шагов шаги шаг шагом
рекомендовать: рекомендованных рекомендованные рекомендовала рекомендуют рекомендует рекомендовали
инициировать: инициирует инициировали
служить: служит служить служат
связующий: связующим
звено: звеном звена
баланс: баланс
родитель: родителей родители родителям
эстония: эстонии
поддержать: поддержать поддержат поддержавших
научить: научила научили
мыслить: мыслить мысли
подругому: подругому
здоровый: здоровое здоровый здоровую здоровому здоровой здорового здоровыми здоровы здоровым здоровая здоровых здоровые
недоступный: недоступным недоступной недоступно недоступное недоступны
фаофлернерид: фаофлернерид
рацион: рацион рационов
разнообразный: разнообразен разнообразные разнообразных
сбалансировать: сбалансирован
отличаться: отличается отличаются
умеренность: умеренностью
отвечать: отвечает отвечая отвечать отвечаю отвечающие отвечаем
оправиться: оправились оправиться
сбой: сбоев сбоям
говориться: говорится
доклад: докладе доклад доклада докладу
продовольственный: продовольственной продовольственная продовольственную
подготовить: подготовленном подготовлен подготовлены подготовленный
учреждение: учреждениями учреждения учреждений учреждение учреждениям учреждениях учреждением
цена: цены цена цене цен
значительный: значительной значительные значительный значительными значительная значительную значительных значительное значительным
степень: степени степенью степень
компенсировать: компенсировано компенсировать
восстановление: восстановлением восстановления восстановление восстановлению
экономика: экономики экономику экономике экономик
доход: доходов дохода
пища: пищу пищи
составить: составил составила составить составленными составили составит составлены
упасть: упало
допандемического: допандемического
средний: среднего среднем средним среднюю средняя средний
напротив: напротив
экономист: экономист
сельскохозяйственный: сельскохозяйственной сельскохозяйственных сельскохозяйственная
нация: наций
фао: фао
максимо: максимо
тореро: тореро
трансжиров: трансжиров
отдел: отдела отделов
агропродовольственной: агропродовольственной
дэвид: дэвида
лаборда: лаборда
свидетельствовать: свидетельствуют свидетельствует
структурный: структурной
проблема: проблеме проблемы проблемой проблема проблем проблемами проблему проблемах проблемам
агропродовольственных: агропродовольственных
лаборд: лаборд
выявить: выявил выявлен выявлены выявлена выявлено выявила выявило выявленных
различие: различия различиями
внутри: внутри
вывод: выводы вывод выводами
доля: доля доли
латинский: латинской
карибский: карибском
бассейн: бассейне бассейнов бассейны бассейн
океания: океании
маттингли: маттингли
коллекция: коллекция
образец: образцов образцы
использовать: используемая используемой используют используя использовать используемых использую использует используемую используемым используемые использовали использованы
консультация: консультациях консультации консультаций консультация
центр: центре центров центра центры центрах центрам центру центр центром
хошимин: хошимине
вьетнам: вьетнам вьетнаме вьетнама
отражать: отражают отражает
неравномерный: неравномерное неравномерным
распределение: распределение распределению распределения
необходимый: необходимых необходимую необходимой необходимы необходимые необходимого необходима необходимым необходимыми необходимому необходимое
развить: развитые развиты развитой развитых развитым
выгодный: выгодном выгодные
положение: положении положение положения
преодоление: преодоления преодоление
цепочка: цепочках цепочка цепочки
поставка: поставок поставки поставка
инфляция: инфляции
методология: методологии
автор: авторы
паритет: паритету
покупательный: покупательной
способность: способности способность способностью
вырасти: выросли вырастет выросло выросший вырасту
ослабить: ослаблено ослабленным ослаблен ослабленный
исследование: исследования исследований исследование исследованиями исследованиям исследовании
совокупность: совокупности
измерение: измерению
отслеживание: отслеживанию отслеживании отслеживания отслеживание
стоимость: стоимости стоимость
индикатор: индикатором
ранний: раннего ранней ранних раннему раннее раньше ранняя раннем раннюю
дешевый: дешевое дешев
вероятно: вероятно
сталкиваться: сталкиваются сталкивается сталкивающихся сталкиваясь сталкивалась
некоторый: некоторой некоторую некоторое
отсутствие: отсутствия отсутствие отсутствии отсутствием
задержка: задержка задержки задержек задержками
истощение: истощение
необходимость: необходимость необходимости необходимостью
мобилизация: мобилизации мобилизацию
инновационный: инновационных инновационный
агропродовольственные: агропродовольственные
предлагать: предлагает предлагаемых предлагаемая предлагаем предлагают
повышение: повышения повышение повышению повышением
ноябрь: ноября ноябре
деть: день дело
карантин: карантина карантин
юнисефтион: юнисефтион
вскармливать: вскармливают
увеличиться: увеличилось увеличится увеличившись увеличатся увеличились увеличилась увеличиться увеличился
детский: детский детского детском
стартовать: стартующей стартовал стартовала стартовать стартует
хотя: хотя
скачок: скачок
приближать: приближает
увеличение: увеличению увеличение увеличением увеличения
совместный: совместном совместной совместную совместный совместного совместных совместная
исполнительный: исполнительный исполнительным исполнительного
кэтрин: кэтрин
рассел: рассел
сотня: сотни
содержаться: содержащиеся содержится содержащихся содержатся содержащимися
антитело: антитела
защищать: защищают защищать защищали защищающих защищает защищаем
малыш: малышей малыше
выигрывать: выигрывают
иметься: имеющимся имеющиеся имеющихся имеется имеющейся имеются
улучшение: улучшение улучшению улучшении улучшения
гарантировать: гарантирует гарантировать гарантируя
безопасный: безопасный безопасных безопасного безопасными безопасным безопасное безопасная безопасной безопасному безопасны
питательный: питательный питательной питательными
доступный: доступный доступных доступен доступными доступна доступную доступны доступной
источник: источник источники источников
маленький: маленьких меньше мало маленькой
снижать: снижает снижая снижают
вид: видов вида виды вид видах видами видом
смертность: смертность смертности
исторический: исторического исторические историческое
оценка: оценкам оценки оценка оценку
спектр: спектру спектра спектр
поэтому: поэтому
оптимальный: оптимального оптимальной оптимальным
протяжение: протяжении
кормление: кормления
собирать: собирает собирают
сбор: сбора сбор
повысить: повысить повысит повысила
эффективность: эффективность эффективности
статистика: статистика статистики
власть: власти властям властей властями
вводить: вводят вводить вводит вводимый вводимые вводя
увеличиваться: увеличиваются увеличиваться увеличивается
раз: раза разы
увеличивать: увеличивать увеличивает
внедрять: внедрять
соответствующий: соответствующую соответствующее соответствующие соответствующих соответствующий соответствующей
рабочий: рабочих рабочие рабочем рабочая рабочий
ограничивать: ограничивающие ограничивать ограничивают ограничивает
ключ: ключ
прикладывать: прикладывают
час: час
лишать: лишая лишает лишают
прививка: прививки прививок прививку прививке прививках прививка
смесь: смесей
соцсети: соцсети
запускать: запускает
птичий: птичьего птичий птичьим
банксмаккурти: банксмаккурти
программа: программы программа программу программах программ программе программами программой программам
передача: передачи передачу передача передаче передачей
технология: технологий технологии технология технологиям технологиях
разработать: разработана разработанная разработанных разработала разработать разработанный разработал разработано разработанную разработаны разработали
внедрить: внедрена внедрили
платформа: платформа платформ платформу платформе платформы
определение: определения определение
иммуногенности: иммуногенности
вакциныкандидата: вакциныкандидата
ускорение: ускорение ускорения
обеспечение: обеспечения обеспечению обеспечением обеспечение обеспечении
вакцинкандидатов: вакцинкандидатов
матричный: матричной
рнк: рнк
мрнк: мрнк
аргентинский: аргентинский
возглавить: возглавит возглавил
совместно: совместно
пул: пулом
патент: патентов
лекарственный: лекарственные лекарственным лекарственной лекарственная лекарственными лекарственно лекарственных
средство: средства средств средством средство средствах средствам средствами
запустить: запущена запустила запущенной запустили
потенциал: потенциала потенциал потенциалом потенциалу
компанияпартнер: компанияпартнер
завершить: завершит завершила завершить
доклинический: доклинические доклинических
опыт: опыт опыте опыта опытом
передать: переданы передать передала передали
партнерампроизводителям: партнерампроизводителям
готовность: готовности готовность
потенциальный: потенциальной потенциальных потенциальные
демонстрировать: демонстрирует демонстрировали демонстрировать демонстрируя демонстрируют
учредить: учредила
именно: именно
содействие: содействия содействие
наступление: наступления наступление наступлением
следующий: следующей следующий следующим следующие
справедливый: справедливых справедливому справедливого справедливую справедливый
ответный: ответных ответные ответного
немедленный: немедленным немедленной немедленный немедленному немедленное
предотвращение: предотвращения предотвращению предотвращение
изза: изза
широкий: широкой широко широкого широкому широкое широкий широкие широкую
животное: животных животными
дополнять: дополняет
текущий: текущую текущей текущие текущего
механизм: механизма механизмов механизмы механизмами
пандемический: пандемическому
обмен: обмена обмену обменом обмен
модель: моделях модели
наличие: наличия наличие наличии
мрнквакцин: мрнквакцин
китай: китая китае китаем китай
сша: сша
скот: скота скотом
повод: поводу
сектор: секторе секторах сектора секторами секторов сектору сектор
возобновиться: возобновится возобновилась
бапор: бапор
сотрудница: сотрудница
проходить: проходить проходит проходят
объявить: объявила объявил объявили объявивший объявлены объявило
оральный: оральную оральной
нопв: нопв
решить: решено решил решить решили
нынешний: нынешняя нынешней нынешние нынешним нынешнего
обстановка: обстановка обстановке
перенаселенность: перенаселенность
убежище: убежищ убежищах
повредить: поврежденную повреждены поврежден поврежденные
водоснабжение: водоснабжения водоснабжением
санитария: санитарии санитарией
гигиена: гигиены гигиеной гигиена
усугублять: усугубляет усугубляют
предыдущий: предыдущих предыдущей предыдущая предыдущий
раунд: раунда раунд
сентябрь: сентябре сентября
октябрь: октябре октября
подолгу: подолгу
сохраняться: сохраняется сохраняются
дополнительный: дополнительные дополнительную дополнительным дополнительных дополнительной
привить: привить привиты привьет привит
укрепить: укрепить укрепит
иммунитет: иммунитет иммунитетом иммунитета
присутствие: присутствие
опасность: опасность опасности опасностей
столкнуться: столкнулись столкнуться столкнутся
особый: особого особое особых особой особую
внимание: внимания внимание вниманию
труднодоступный: труднодоступных труднодоступные труднодоступной труднодоступном
населенный: населенных населенными
пункт: пунктах пункта пунктов пунктами пункты
джабалия: джабалия
бейтлахия: бейтлахия
бейтханун: бейтханун
пауза: паузы паузе пауз паузах пауза паузам
семь: семи семь
пройти: прошли прошла прошел пройти пройдет
второе: второго второе вторым
тот: тех той тому теми
полиовирусом: полиовирусом
парализовать: парализован парализованы
десятимесячный: десятимесячный
дейрэльбалаха: дейрэльбалаха
ханюниса: ханюниса
собрать: собранные собрали собранных
декабрь: декабре декабря декабрю декабрь
январь: январе января январь
подтверждать: подтверждают подтверждает
проводиться: проводиться проводятся проводится проводился проводилась
руководство: руководством руководство руководства руководстве
палестина: палестины палестине
агентство: агентства агентство агентств агентствами агентстве агентством агентствах
палестинский: палестинским палестинской палестинские палестинских палестинском палестинское палестинскими палестинского
обстрел: обстрелы обстрелом обстрелов обстрелами обстрел
бомбардировка: бомбардировки бомбардировок
задерживать: задерживают
север: севере севера север
охватить: охваченном охвачено охватить охватившему
боев: боевыми боевых
готовый: готово готова готовы готовые готовых
больной: больных больными больные больны больным
ивонна: ивонн
операция: операцию операций операция операциях операции
удаление: удалению удаления
злокачественный: злокачественной
опухоль: опухоли
минне: минне
нигерия: нигерия нигерии
диагностироваться: диагностируется
выживаемость: выживаемости выживаемость выживаемостью
улучшиться: улучшились улучшится
диагностический: диагностическим диагностического диагностических диагностические диагностическую диагностический
лечение: лечению лечения лечение лечении лечением
служба: службам служб службы служба службами службе службу
ограничить: ограничен ограниченном ограниченным ограниченный ограниченными ограниченное ограничены ограниченные ограничена ограничено ограниченной
отмечать: отмечают отмечает отмечала отмечали
беззащитный: беззащитными
онкологический: онкологическими онкологических онкологические
оккупировать: оккупированной оккупированные оккупированных оккупированном
территория: территории территориях территорий территория
йемен: йемене йемен
переполнить: переполнены переполненных
персонал: персонала персонал персоналом
хватать: хватает
препарат: препаратов препараты препаратам препаратами препарата препарат препаратах
прервать: прерваны прервана прервать
разрушить: разрушены разрушена разрушенного разрушенной
соседний: соседние соседних соседней
разрешение: разрешение разрешения
умирать: умирали умирают умирает умирать умирающих
дождаться: дождавшись
негативный: негативно негативных негативными негативным негативного негативное негативные
сказываться: сказываются сказывается сказываться сказываясь
затяжной: затяжные затяжными затяжных затяжного
ливия: ливии
острый: острая острого острый острой острее острую острых острое острым
онкология: онкологии онкология онкологией
врачаонколога: врачаонколога
врачарадиолога: врачарадиолога
зона: зонах зоне зон зону зоны зона
товар: товары товаров товар товарах товарам
поддерживать: поддерживая поддерживает поддерживают поддерживать поддерживаемыми поддерживали поддерживаемом поддерживаемая поддерживаем поддерживаемую
местный: местные местных местный местным местную местными местном местному местное местной местная
обучать: обучая обучаем обучаемых
медработник: медработников медработникам медработники
устранить: устранить устранены
хронический: хронические хронических хроническими хронического хроническим
перебой: перебои перебоев перебоями
контекст: контекстах контекста контексте
клиника: клиник клиникой клинике клиники клиника клинику клиниках
лечить: лечить
детейпереселенцев: детейпереселенцев
отдаленный: отдаленных отдаленные
психологический: психологическую психологические психологической психологическими психологическое психологическая
говорить: говорит говорили говорить говоря говорила говорим
асмус: асмус
хаммерих: хаммерих
россия: россии россией россия россию
специальность: специальность специальностью специальностей
онкологгематолог: онкологгематолог
одобрить: одобрила одобренных одобрена одобрил
революционный: революционный революционные
туберкулез: туберкулез туберкулезом туберкулеза туберкулезе
государственный: государственные государственный государственная государственного государственное государственным
эбола: эбола
уганда: уганде уганды
дрк: дрк
приостановка: приостановка приостановки приостановке
американский: американского американских американской
финансирование: финансирования финансирование финансировании финансированием
гендиректор: гендиректор
девять: девять девятью девяти
лихорадка: лихорадкой лихорадка лихорадку
летальный: летальный летальному летальном летального летальных
наблюдение: наблюдением наблюдения
контактировать: контактировавших контактирующих
заболеть: заболевшими заболели заболевших заболел заболевшие
оперативный: оперативную оперативных оперативной оперативное оперативные
эпидемнадзора: эпидемнадзора
лабораторный: лабораторного лабораторные лабораторных лабораторно
логистика: логистики
профилактика: профилактики профилактике профилактику профилактика профилактикой
контроль: контроля контролю контроль контролем
логистический: логистических логистическую логистической
найроби: найроби
дубай: дубае
официально: официально
терапевтический: терапевтических терапевтическим
сотрудничество: сотрудничеству сотрудничество сотрудничества сотрудничестве
научный: научных научно научными научные научный научным научного научная научную
начать: начать начнут начнем начали начнет начав начаты
испытание: испытание испытаниями испытанием
выделить: выделил выделить выделено выделены
резервный: резервного
дополнение: дополнение
внести: внесен внести
первоначальный: первоначального первоначальная первоначальной первоначальный первоначальное
реагирование: реагирования реагированию реагирование реагировании
демократический: демократической демократическая демократическими демократическую
конго: конго
провинция: провинциях провинции провинций
киву: киву
добраться: добраться
оспа: оспы оспой оспе оспа оспу
обезьяна: обезьян
морг: морги
продолжить: продолжил продолжит продолжат продолжили продолжить
круглосуточно: круглосуточно
предвидеть: предвидя
заблаговременный: заблаговременным
топливо: топливо топлива
запас: запасы запасов
заканчиваться: заканчиваются заканчивается
склад: склады
разграбить: разграблены
режим: режима режиме режимы режим
автомашина: автомашин
груз: грузами груза
ответ: ответ ответа ответов
беречь: берегу берег беречь
предмет: предметы предмет предметом предметов предметами
почему: почему
соблюдение: соблюдение соблюдения
освобождение: освобождение освобождению освобождения
заложник: заложников заложники
напомнить: напомнил напомним напомнили напомнила
осуществляться: осуществляется
соединить: соединенных соединенные соединенными соединенное
штат: штатов штаты штатами штатах штате
сожалеть: сожалеем сожалеет сожалеют
намерен: намерены намерен намерена
выйти: выйти вышли
конструктивный: конструктивного конструктивный
диалог: диалога диалог диалогу диалогов
предпринимать: предпринимает
членство: членством членства
президент: президента президенты президент
оказание: оказанию оказании оказания оказание
спид: спидом спида спид спиду
тестирование: тестированию тестирование тестирования тестировании
вич: вич
внезапный: внезапная внезапного
институт: институтов институты
искоренение: искоренению искоренении искоренения
противодействие: противодействие противодействии противодействию противодействием противодействия
рапространению: рапространению
просить: просим просит
рассмотреть: рассмотреть
пока: пока
найти: найдены найдут найти нашла найдите
альтернативный: альтернативные альтернативных
комиссия: комиссия
усовершенствовать: усовершенствовать
внешний: внешней внешнюю внешнем
ставить: ставит ставить ставят
юнэйдс: юнэйдс
эфиопииб: эфиопииб
асс: асс
эфиопия: эфиопии
приостановить: приостановить приостановлен
вичспиду: вичспиду
взрослый: взрослых взрослым взрослого взрослыми
прекратить: прекратили прекратить
написание: написания
интернетпортал: интернетпортал
реальный: реального реальную реальный
портал: портале
делиться: делиться делится делятся делился делимся
рекомендация: рекомендациями рекомендации рекомендациям рекомендаций рекомендацией
смягчение: смягчения смягчению
вклад: вклад
трудный: трудно трудный трудной трудные
переоценить: переоценить
неизменный: неизменным
лидер: лидером лидеры лидеров лидер лидерами
пепфар: пепфар
посредство: посредством
невозможно: невозможно
спас: спас
инвестировать: инвестируя инвестировать
госдепартамент: госдепартамент госдепартамента
дневной: дневной
иностранный: иностранной иностранных иностранным иностранные
утратить: утратил
реализовывать: реализовывать
объем: объеме объемом объемы объема объем
остановить: остановлена остановить
навсегда: навсегда
вичинфекции: вичинфекции
прогноз: прогнозами прогноз прогнозы прогнозам
учет: учетом учете
возобновление: возобновления возобновление
образ: образом образа образ образу
ликвидация: ликвидация ликвидации
реалистичный: реалистичная
сегодняшний: сегодняшний сегодняшние сегодняшняя
наметить: намеченная наметить намеченной
невозможный: невозможной невозможного невозможным невозможен
предоставление: предоставление предоставления предоставлению предоставлением
возобновить: возобновлено возобновить возобновлены
день: дней днях дня дню дни дне
спустя: спустя
дипломатия: дипломатии
осуществлять: осуществляющее осуществляет осуществляющих
надзор: надзор надзора
выпустить: выпустило выпустила выпущенные выпустили выпустить
меморандум: меморандум меморандуме
отказ: отказе отказа
консультирование: консультирование
оппортунистический: оппортунистических
закупка: закупку закупок закупки
лекарство: лекарств лекарства лекарствами лекарствам лекарство
заявлять: заявляют
приверженный: привержена привержено
лидерский: лидерской
приветствовать: приветствуют приветствовал приветствует приветствуя приветствовали
исключить: исключить исключены
ликвидировать: ликвидировать ликвидировали ликвидирована ликвидирован
длительный: длительного длительной длительная
революция: революция революцию
угрожать: угрожает угрожать угрожают угрожающие угрожающем
загрязнение: загрязнение загрязнения загрязнением загрязнении
воздух: воздуха воздухом воздух
юнисефвсохин: юнисефвсохин
прогулка: прогулкой прогулки
воспитательница: воспитательница
сад: сада сад
монголия: монголии
надевать: надевает надевать
маска: маски масок маску маска
младший: младше младшего
остров: островах
разрушительный: разрушительное разрушительных разрушительной
влияние: влияние влиянию влияния влиянием влиянии
токсичный: токсичного токсичные токсичных токсичными
четвертая: четвертая
загрязненный: загрязненного загрязненным загрязненные загрязненной загрязненными
начинаться: начинается начинаться
утроба: утробе
вес: веса вес
рождение: рождении
детство: детстве
дыхательный: дыхательной дыхательных
когнитивные: когнитивные
функция: функции функций функциях
астма: астма
сердечнососудистые: сердечнососудистые
патология: патологии
вдох: вдох
значение: значение значений значения
причинить: причинить причинив
джуна: джун
кунуги: кунуги
природа: природе природой
подвергаться: подвергаются подвергались подвергается
годовой: годового
мелкий: мелких
твердый: твердых твердую
частица: частиц частицы
диоксид: диоксида
азот: азота
выбрасывать: выбрасываемого
транспорт: транспортом транспорта транспорте
промышленный: промышленными
предприятие: предприятиями предприятия предприятий предприятиях
сжигание: сжиганием
ископаемое: ископаемого
биомасса: биомассы
отходы: отходов отходами отходы
явленье: явлений
далекоидущие: далекоидущие
школа: школы школа школах школу школе школами
закрываться: закрываться
образовательный: образовательному образовательные
процесс: процессу процесс процессов процесса процессом процессе
обслуживание: обслуживание обслуживанию обслуживания
создавать: создавая создает создавать
нагрузка: нагрузку нагрузки нагрузке
банк: банка банк банков
эквивалентный: эквивалентно
валовой: валового
ввп: ввп
призыв: призыв призыве призывом
бизнес: бизнес бизнесу бизнесом
педагог: педагогов педагоги педагогами
немедленно: немедленно
ужесточить: ужесточить
экологический: экологические экологических экологического экологическом экологический
норма: нормы норму норма
переходить: переходить
чистый: чистые чистый чистых чистой чисто чистую чистого
энергия: энергии энергию энергия энергией
стандарт: стандарты стандартами
экологически: экологически
сокращать: сокращать сокращают
выброс: выбросы выброса выбросов
приоритет: приоритет приоритетов приоритеты приоритетах приоритета приоритетом приоритете
играть: играют играет играть играющей
ключевой: ключевую ключевых ключевым ключевой ключевое ключевая ключевыми ключевые
отстаивать: отстаивая отстаивать
вовлекать: вовлекая
молодежь: молодежь молодежи молодежью
регулирование: регулирования регулированию регулирование
установка: установки установка установке
датчик: датчиков
дом: домах доме дому домом
кухонный: кухонных
плита: плит
улучшить: улучшенную улучшить улучшенные улучшив
вентиляция: вентиляцию вентиляции
диагностик: диагностики диагностике диагностика диагностику
стремление: стремлении
ускорить: ускорить ускорит
вмо: вмо
саймон: саймон
стил: стил
запросить: запросили запросил
укгвю: укгвю
верес: верес
транзитный: транзитном транзитных
днепр: днепре днепр
полномасштабный: полномасштабной полномасштабного полномасштабное
опубликовать: опубликовала опубликовали опубликованы опубликованный опубликованном опубликованного опубликовано опубликован
планировать: планирует планировать планируем планирующих
реформирование: реформирование
общий: общая общей общего общий общих общее общие
сумма: сумма
иной: иной иными иного ином иных иным
форма: форме формой форм форма форму
входить: входят входящих входит входите
критический: критическими критической критическом критических критический
непредсказуемость: непредсказуемость
ухудшение: ухудшению ухудшением ухудшении
стабилизация: стабилизации
полагать: полагают
заглядывать: заглядывая
сосредоточить: сосредоточены сосредоточенное сосредоточено сосредоточим
поддержание: поддержании
цифра: цифрами цифры цифра
опасаться: опасающейся
пожилой: пожилого пожилых пожилые пожилым
психический: психического психическое психических психическим психическому психическом психические
трехлетнего: трехлетнего
мальчик: мальчика мальчиков мальчик мальчиками
пропустить: пропустившего пропустит
стремиться: стремится стремясь стремимся
тесно: тесно
три: трех тремя
поразительный: поразительную
стойкость: стойкость
ярно: ярно
хабихт: хабихт
самоотверженный: самоотверженных
украинский: украинских украинские украинской украинскую украинская
врач: врачей врачи врачу врач врачам врачом врача
волонтер: волонтеров волонтеры волонтерами волонтером
одновременно: одновременно
столь: столь
реформа: реформы реформа реформам реформ
стратегия: стратегия стратегии стратегиях стратегию стратегий
экстренный: экстренной экстренного экстренную экстренное экстренном
непрерывность: непрерывности непрерывность
устранение: устранение устранения устранению
глубокий: глубоких глубокой глубокое глубокие глубокую
линия: линии линию
соприкосновение: соприкосновения
кыргызстан: кыргызстане кыргызстана кыргызстан кыргызстану
спасение: спасению спасения спасение
координатор: координатор
проснуться: проснуться
хэрри: хэрри
умереть: умерли умерло
задача: задача задачей задач задачу
четкий: четкого четкие четкий
видение: видения видение
решительный: решительных решительным решительные
национальный: национальных национальную национальная национальным национальный национальной национальные национальном национального национальными
орган: органов органы органами орган органам
четвертый: четвертого четвертое четвертый
рассказывать: рассказывает рассказывают рассказывать рассказывали рассказывала
ежегодный: ежегодный ежегодном ежегодная ежегодные ежегодного ежегодных ежегодной
варьироваться: варьируется
путем: путем
предел: пределами пределе пределах предел
ясный: ясно
передовой: передовых передовой передовым передового
принести: принести принесет
наблюдать: наблюдаем наблюдаемый
постепенно: постепенно
реализоваться: реализуется реализуются
доктор: доктор доктором
султан: султан
стамбеков: стамбеков
онколог: онколог онкологов
имя: имя
добиваться: добивается добиваются добиваться
прогресс: прогресса прогресс прогрессу
тесный: тесному тесное тесном
страновой: страновым странового страновых страновой страновые
шейка: шейки
матка: матки
папиллома: папилломы
впч: впч
затрагивать: затрагивает затрагивали
общество: общества обществом обществе общество обществах
чувствительный: чувствительной
алин: алина
алтымышева: алтымышева
заинтересовать: заинтересованные заинтересованными заинтересованным
известный: известный известной известного известными
протокол: протокол протокола протоколов
уделяться: уделяется уделяться
обосновать: обоснованный обоснованных обоснованные
подход: подход подходе подходы подхода
опробовать: опробованный
ограничение: ограничения ограничений ограничение ограничениями
барьер: барьеры барьеров барьерами
заключаться: заключается заключалось заключающейся
выявление: выявления выявление выявлению выявлении
поддаваться: поддающихся поддавался поддаются поддающиеся поддается поддаваться
первое: первого первые первых первом первым первое
предраковым: предраковым
поражение: поражениям поражений поражение
развертывание: развертывание развертывания
своевременный: своевременной своевременные своевременного своевременное своевременную
девочка: девочек девочка девочки девочкам девочку
процентный: процентного процентных процентную
довольный: довольно
слабый: слабо слабее слабую слабый
отсутствовать: отсутствовали отсутствует отсутствуют
исследовательский: исследовательской исследовательского
святой: святого
иуда: иуды
добиться: добилась добиться добились добился
успех: успехов успех успехи успеха успехом
бишкек: бишкеке
ош: оше
приведение: приведение
соответствие: соответствие соответствия соответствии
трансплантация: трансплантация
костный: костного
мозг: мозга
гематолог: гематологов
признать: признана признала признает признаем
отдельный: отдельной отдельные отдельных
полноценный: полноценная полноценную полноценного полноценными
многократный: многократное многократного
дорогой: дорога дороже дорогие дорог
вперед: вперед
достигнутый: достигнутый достигнутые достигнутое
постоянный: постоянными постоянного постоянным постоянный постоянной постоянная постоянные
закладывать: закладывает закладывать
прочный: прочную прочным прочная
партнерский: партнерские партнерским
отношение: отношения отношении отношений отношение отношениям отношению отношениях
бремя: бременем бремя
таджикистан: таджикистану таджикистане
справиться: справиться справилась
тонный: тонны
пересмотреть: пересмотреть пересмотрят пересмотренными пересмотрев
выход: выходе выход выхода выходу выходом
оонэшнейдер: оонэшнейдер
понедельник: понедельник
дональд: дональда дональд
трамп: трампа трамп
указ: указ
сожаление: сожаление сожалению
сохранить: сохранить
несогласие: несогласие
аргумент: аргументами аргументы
баз: базы базу базе базам
донор: доноров донором
бюджет: бюджета бюджет
зависимость: зависимости зависимость
элемент: элементом
отвергнуть: отверг
обвинение: обвинения
сигнал: сигналы сигналом
вирусный: вирусной вирусную вирусным
ухань: ухане
задействовать: задействовали
управление: управления управлению управление управлением управлении
детальный: детальные
якоб: якобы
неуместный: неуместному
политический: политическому политической политическим политическая политическую политические
государствчленов: государствчленов
беспристрастный: беспристрастна беспристрастную
государствачлены: государствачлены
обращаться: обращаются обращается обращаться
запрос: запросами запрос
стараться: стараемся стараясь стараюсь старайтесь
насколько: насколько
возможно: возможно
подкрепить: подкреплен
противоречить: противоречит
миссия: миссии миссия миссий миссию
вежливо: вежливо
отказывать: отказываем отказывают
изучать: изучают
выплата: выплаты выплат
эпицентр: эпицентр эпицентром
перемещаться: перемещается
индий: индия индии
уповать: уповать
лето: лето летом лету
соблюдать: соблюдать
физический: физическую физического физическое физические физических физической физическим физическом
дистанция: дистанцию
юнисефафарран: юнисефафарран
иммунодефицит: иммунодефицита
фон: фоне
замораживание: замораживания
марко: марко
рубио: рубио
утвердить: утвердил
далекий: дальше далека далеких
вести: ведущей ведет вести ведут ведущую ведущих
мировой: мировой мировая мировые мирового мировых мировое мировыми мировым
исключение: исключение исключениям исключением исключения
жизненно: жизненно
винни: винни
бьянима: бьянима
департамент: департамент департамента
внешнеполитический: внешнеполитических
администрация: администрации администрацией администрацию
затронуть: затронет затронутых затронула затронули затронуло затронуты затронутые затронувшей затронутым
уделять: уделять уделяет уделяя
приоритетный: приоритетное приоритетные приоритетных приоритетный приоритетного приоритетной
лидерство: лидерству лидерство
объявление: объявлением
синтетический: синтетических синтетические синтетическими синтетический
наркотик: наркотиков наркотики наркотиками
перестройка: перестройке перестройки
рынок: рынков рынках рынкам рынке рынка рынок
унп: унп
оонюкондратович: оонюкондратович
обладать: обладать обладающих обладают обладает обладал
горазд: гораздо
фармакологический: фармакологической фармакологическую
активность: активностью активность активности
растительный: растительного
происхождение: происхождения
комитет: комитета комитет
мккн: мккн
быстрый: быстрый быстрое быстрее быстром быстрые быстрым быстрого
масштаб: масштабов масштабах масштабы масштаб масштабам масштаба
изготовление: изготовления изготовление изготовлением изготовлении
смертельный: смертельно смертельной смертельный смертельные смертельных смертельному
вследствие: вследствие
передозировка: передозировки
погибать: погибают погибает погибали
изготавливаться: изготавливаются
вводиться: вводятся
незаконный: незаконный незаконным незаконного незаконных
оборот: оборот оборотом оборота
криминальный: криминальные криминальными криминальных
структура: структуры структурами структур структуре
наращивать: наращивают наращиваем
выгода: выгоду
нитазены: нитазены
продвигаться: продвигаются
героин: героин
польша: польше
изъятие: изъятия
ирландия: ирландия ирландии
франция: франция франции
нитазенов: нитазенов
утверждать: утверждают утверждает
вещество: веществ вещества веществами веществам веществом
разрабатывать: разрабатываемых разрабатывать разрабатывает
имитация: имитации
достаточно: достаточно
простой: прост простые проще
технический: технических технической технический
знание: знаний знаниями знания
сопрячь: сопряжен сопряжены сопряжена сопряжено
трудозатратами: трудозатратами
операционный: операционными операционные операционный операционной
издержка: издержками издержки
психоактивный: психоактивных
опиоидов: опиоидов
немедицинский: немедицинского немедицинских
назначение: назначения назначение
открывать: открывает
практический: практически практический практические
безграничный: безграничные
коренной: коренной коренные коренных
наркорынков: наркорынков
прекурсоры: прекурсоры
причем: причем
правоохранительный: правоохранительные правоохранительных
постановка: постановке постановки постановку
оказываться: оказываются оказывается оказывались
догонять: догоняющих
земля: земли земля
людская: людские
высадок: высадки
растенье: растений
переработка: переработки
урожай: урожая
растение: растения
спутниковый: спутников
принудительный: принудительно принудительные
уничтожить: уничтожены
трудозатратах: трудозатратах
наладить: налажено наладить
делаться: делается
близкий: ближе близком
транзит: транзита
добавление: добавление
фентанила: фентанила
карфентанила: карфентанила
сильнодействующий: сильнодействующие
опиоиды: опиоиды
масса: массе массы масса
попадать: попадают попадать попадая
сложный: сложнее сложной сложных сложным сложную
обнаруживать: обнаруживать
сократить: сократить
увеличить: увеличить увеличили увеличило
прибыль: прибыль
уменьшить: уменьшить уменьшите
пресечение: пресечения
наркоторговец: наркоторговцы
менять: меняют менять меняет
переправка: переправки
небольшой: небольших небольшую небольшая небольшой невелика
партия: партий
легкий: легче легкую
спрятать: спрятать
способ: способы способ способов способом
контрабанда: контрабанды
беспилотный: беспилотные
летательный: летательные
аппарат: аппараты
курьер: курьеры
почтовый: почтовые
стремительный: стремительный стремительному стремительного
сердечнососудистой: сердечнососудистой
наркологический: наркологических
расстройство: расстройств расстройство расстройства
употреблять: употребляющих употребляют употребляемых употребляло употребляет употреблять
мдма: мдма
экстези: экстези
амфетамин: амфетамины
кетамин: кетамин
спайс: спайс
испарение: испарения
пожар: пожары пожарах пожара пожаров
взрыв: взрывы
изготовитель: изготовителей
сотрудник: сотрудников сотрудники сотрудник сотрудника сотрудниками
сложность: сложности
быстро: быстро
прекурсоров: прекурсоров
предпрекурсоров: предпрекурсоров
контролировать: контролирующие контролируемого контролировать
искусственный: искусственный искусственного
интеллект: интеллект интеллекта
молекулярный: молекулярных молекулярного
химический: химических химическим химические
послужить: послужит
опережать: опережать опережала
создать: создана создаст созданных создали создать
скоординировать: скоординированная скоординированный скоординированные
достаточный: достаточной достаточными достаточная достаточное
подготовиться: подготовиться
компетентный: компетентных компетентными
координация: координации
внутригосударственный: внутригосударственном
оповещение: оповещения оповещений
информирование: информирования информированию
трудоспособность: трудоспособности трудоспособность
выполнение: выполнение
тщательный: тщательных тщательный тщательному тщательного
последовательный: последовательных последовательной
составление: составления составлении
картина: картины картин картину картина
функционирование: функционирования
сеть: сетей сетях сети сеть
характер: характера характер
государственночастных: государственночастных
партнерство: партнерств партнерства партнерство партнерству
вовлечение: вовлечению
электронный: электронной электронным электронного электронные
торговля: торговли торговля
преступный: преступной
индустрия: индустрия индустрии
запретить: запрещенных запретили запрещено запретить запрещен
стремительно: стремительно
возникать: возникают возникает
незамедлительный: незамедлительного
лазейка: лазейки
законодательство: законодательстве законодательство
сообща: сообща
потребление: потреблением потребления потребление
наркоторговля: наркоторговля
наркотрафиком: наркотрафиком
уругвай: уругваю
недопустимость: недопустимости
каннабиса: каннабиса
изъять: изъяли
грузия: грузии грузию грузия
присвоить: присвоен
статус: статус статуса статусе статусу
свободный: свободной свободный свободного свободными свободную
малярия: малярии малярией малярия малярию
мераджи: мераджи
тбилиси: тбилиси
присоединиться: присоединилась присоединились присоединился
рубеж: рубежа рубежи
поздравлять: поздравляем
народ: народ народов
целенаправленный: целенаправленных целенаправленным целенаправленной
давать: дает даем давайте дают
надежда: надежду надежды
сертификат: сертификат
происходить: происходит происходят
вакуум: вакууме
самоотверженность: самоотверженности самоотверженность
выдаваться: выдается выдающихся
регистрироваться: регистрировались регистрируется регистрируются регистрироваться
подряд: подряд
министр: министр министры
михаил: михаил
сарджвеладзе: сарджвеладзе
сертификация: сертификация сертификацию сертификации
признание: признанием признание
стабильность: стабильности
означать: означает означают
сто: сто ста
преследовать: преследует
древние: древних
эндемичны: эндемичны
малярийный: малярийных
паразит: паразитов паразиты
комар: комарами
лечебный: лечебным
второй: вторая вторую второй
снова: снова
послевоенный: послевоенный
распыление: распыление
инсектицид: инсектицидов
усиленный: усиленный усиленные
энтомологический: энтомологический
окончательный: окончательная
подписать: подписала подписавшие подписал подписали
ташкентский: ташкентскую
декларация: декларацию декларации декларация
последовать: последовавшие последовало последовала последовав
локальный: локальных
ашхабадский: ашхабадское
обязаться: обязались
приложить: приложить
турция: турция
единственный: единственная единственный единственное единственной единственным
консультативный: консультативной
элиминация: элиминации
функционировать: функционирует функционируют функционировать функционирующими
располагать: располагает
список: список списка
патоген: патогенов патогены патогену патогенам
гот: готов
победить: победить победим
затормозить: затормозить
симптом: симптомами симптомы симптомов
недоедание: недоедания недоедание недоеданием недоеданию
полевой: полевом
госпиталь: госпитале
юг: юге юга югу
апрель: апреле
середина: середине
век: века веке
желтый: желтая
обрушиться: обрушились
индустриализация: индустриализации
взаимосвязанный: взаимосвязано взаимосвязаны
императив: императивом
ученый: ученые ученых ученого учеными
премьерминистры: премьерминистры
созвать: созвали созвал
санитарный: санитарную санитарным санитарных
конференция: конференцию конференция конференции конференцией
предшественница: предшественницей
заниматься: занимается занимался заниматься занимающиеся занимающихся занимайтесь
благополучие: благополучием благополучии благополучию благополучие благополучия
вашингтон: вашингтон вашингтона
намерение: намерении
тарик: тарик
ясаревич: ясаревич
американец: американцев
устранять: устраняет
предотвращать: предотвращает предотвращать предотвращают
попасть: попасть попавшим попали попал попадем
укгв: укгв
йенс: йенс
лэрке: лэрке
долгий: дольше долго долгое
чувствовать: чувствуют чувствуем чувствую чувствовать
счастливый: счастливыми
многий: многом
доставлять: доставляют доставляет доставлять
аптечка: аптечки
атака: атак атаками атакам атаки атаке атака атакой
ехать: едут
туда: туда
решаться: решаются
раненый: раненых раненые ранены раненым раненого
команда: команды команда команде командам команд
развернуть: развернуть развернутые
раздирать: раздираемой
осадить: осажденной осажденном
кризисный: кризисных
просеивать: просеивают
сообщение: сообщений сообщения сообщении сообщение
статья: статьи статье
эпиднадзор: эпиднадзору эпиднадзора эпиднадзор
проверять: проверяя проверяю проверяйте
поступать: поступающие поступают поступать
укреплять: укреплять укрепляет
прием: приема приемами
забытый: забытые
трансмиссивный: трансмиссивные
половой: половым полового половую половой половые половыми половых половом половое половому
передавать: передаваемые передавая
недуг: недугами недуги
поставлять: поставляя
бразилия: бразилия бразилии
пакистан: пакистан
тиморлешти: тиморлешти
проказа: проказу
трахома: трахому
сифилис: сифилиса
белиз: белизе белиз
ямайка: ямайке ямайку
сентвинсенте: сентвинсенте
гренадины: гренадинах гренадины
намибия: намибия
гепатит: гепатита гепатит
возннуйя: возннуйя
цифровой: цифровое цифрового цифровую цифровой
осваивать: осваивает осваивать
применение: применения применение
затрагиваться: затрагиваются
минимизация: минимизация
неэтичный: неэтичный
кибербезопасности: кибербезопасности
предвзятый: предвзятого
дезинформация: дезинформации
лесной: лесные лесных
давление: давление давлением давлению
оценивать: оценивать оценивает оцениваем
гражданин: граждан гражданам
потепление: потеплением потепления потеплению
адаптация: адаптации адаптацию
водный: водные водного водном водный
возп: возп
футфенг: футфенг
всеобщий: всеобщий всеобщее всеобщего всеобщему
возглавлять: возглавляет возглавляемых возглавляемые
заключение: заключению
беспрепятственно: беспрепятственно
поправить: поправить
руководить: руководит
базироваться: базирующееся базирующаяся
директивный: директивный
ассамблея: ассамблея ассамблеи ассамблеей
состоять: состоит состоящей состоят
совещание: совещания совещание совещании
согласование: согласования
руководствоваться: руководствоваться
этика: этике
болеть: болеть болеют болели
перечеркнуть: перечеркнуть
юнисефф: юнисефф
кокороко: кокороко
периодический: периодические периодической
инъекция: инъекции инъекций
новаторский: новаторские новаторских
ленакапавир: ленакапавир
каботегравирв: каботегравирв
произвести: произвести произвело
полностью: полностью
изменить: изменить изменили изменила
назвать: названный назвал
прорыв: прорывом
каботегравир: каботегравир
унести: унес унесла унести
целевой: целевой целевого
альтернатива: альтернатива альтернатив
ежедневный: ежедневным ежедневных ежедневные
таблетка: таблеткам таблеток таблетки
молодая: молодые молодая молодым молодых молодыми молодой
лгбтк: лгбтк
сексиндустрии: сексиндустрии
надежный: надежное надежных надежные надежном
преодолеть: преодолеть преодолен
социальный: социальные социальных социальной социальную социальными социального социальный социальное социальным социальном социальному
определить: определенные определенных определить определенную определены
производить: производить производят производимый
фармацевтический: фармацевтические фармацевтической фармацевтическими
лицензионный: лицензионные
соглашение: соглашения соглашением соглашение соглашении соглашению
версия: версий версию
остаться: остались остался остаться осталось оставшиеся оставшихся осталась оставшуюся
борт: бортом
урок: уроках урок уроки уроков
антиретровирусная: антиретровирусная
задерживаться: задерживалась
развивающийся: развивающихся развивающимся развивающаяся
доказывать: доказывает доказывать
шанс: шанс шансов шансы
положить: положить
конец: конец конце концу конца
рассматриваться: рассматривается рассматриваться
поворотный: поворотный
воля: воли
ценообразование: ценообразования
приблизиться: приблизиться приблизился
упустить: упустить
парижский: парижского парижским парижское парижском
оонл: оонл
фелипе: фелипе
штабквартира: штабквартира штабквартире штабквартиру
ньюйорке: ньюйорке
прокомментировать: прокомментировали прокомментировала
распоряжение: распоряжения
рассказать: рассказали рассказал расскажите рассказать рассказала
сдерживание: сдерживанию сдерживании сдерживания
часы: часов
новоизбранный: новоизбранный
белый: белом белой
оба: обе обоих обеих
палата: палаты
конгресс: конгресса
резолюция: резолюцию
предпринять: предпринял предпринять
срок: срока сроки сроков срок
отменить: отменено отменить
байдена: байдена
проанализировать: проанализировать
важность: важность важности
присутствовать: присутствует
упомянуть: упомянув
незаменимый: незаменимая незаменимую
шок: шок
метеорологический: метеорологической
нуллис: нуллис
возвращать: возвращает
президентский: президентского
завершиться: завершившегося завершилась завершился
очевидный: очевидна очевидной очевидные
учитывать: учитывая учитывать учитывали учитывают учитывающие
жаркий: жарким жаркая жарче жарко жарких жаркими жаркому
примерный: примерно
теплый: теплее теплые теплых теплое тепла теплом
доиндустриальный: доиндустриальной доиндустриальный
эпоха: эпохи эпохой эпоха эпоху
вызов: вызов вызовами вызовов вызовы
смертоносный: смертоносных
лосанджелесе: лосанджелесе
катаклизм: катаклизмов
пережить: пережила пережившие пережившим пережить пережил пережили
инцидент: инцидентов инциденту инцидента инцидентах инциденты инцидент
прессслужбе: прессслужбе
трансформация: трансформация
начаться: началась начавшаяся начались начался начаться начнется началось
возобновлять: возобновляемой
процветание: процветания процветание
уверить: уверен уверены
низкоуглеродным: низкоуглеродным
качественный: качественные качественных качественным качественный качественными качественному
экология: экологии
поздравить: поздравил
победа: победой победе победы
выбор: выборах выбором выбор
участие: участию участие участия
генассамблея: генассамблее генассамблеи
несправедливость: несправедливостью несправедливость
самолет: самолет
беспрецедентный: беспрецедентному беспрецедентное беспрецедентным беспрецедентного беспрецедентный
четверг: четверг
остро: остро
выступить: выступил выступившие выступит
излагаться: излагаются
изолированный: изолированными
случайный: случайными
неизбежный: неизбежны
накладываться: накладываются
друг: друг друга друзей другом друзья
усиливаться: усиливаются усиливается
выходить: выходит выходя выходите
уход: ухода уходе уход уходу
первостепенный: первостепенное
справедливость: справедливости справедливость
наследие: наследие наследием
принадлежность: принадлежностей принадлежность
выполнять: выполнять выполняем выполняет
уникальный: уникальную уникальные уникальная уникальным
касаться: касается касался касающиеся касающихся
разрыть: разрыв
каков: каковы каково
генсек: генсек
ветер: ветер ветром
смениться: сменился
безумие: безумия
какой: какие какими какую каким каких
волновать: волнуют
юнисефэльфатих: юнисефэльфатих
эпидемический: эпидемическими эпидемический эпидемического
дефицит: дефицита дефицит дефиците
месяцами: месяцами
зарплата: зарплату
регулярный: регулярной регулярное регулярную регулярные
затруднить: затруднены
шибле: шибле
сахбани: сахбани
перегружать: перегружают
хрупкий: хрупкую хрупких хрупкое
проживание: проживания
вынудить: вынужденных вынужденное вынуждены вынудили вынужденным вынужденные вынудив
переселенец: переселенцев переселенцы
желудочнокишечного: желудочнокишечного
тракт: тракта
гранить: грани
коллапс: коллапса
шелдон: шелдон
йетт: йетт
плечо: плечом плечу
неотложный: неотложные неотложное неотложной неотложную неотложного
модернизация: модернизации
организовывать: организовывать
общинный: общинные
почва: почве
оснащение: оснащение
реагированияи: реагированияи
утихать: утихает
вппдждюмон: вппдждюмон
авиаудары: авиаудары
ухудшить: ухудшили ухудшило
палестинец: палестинцев палестинцам палестинца
офис: офисе офиса офис офисов
верховный: верховного
комиссар: комиссара комиссар
право: правам правах праву праве правами
увкпч: увкпч
кошмар: кошмар кошмарами кошмара
непрекращающийся: непрекращающихся непрекращающиеся
многократно: многократно
домовый: домов
никто: никто никому никого
спасатель: спасателей спасателям
полицейский: полицейских полицейского
израильский: израильская израильской израильские израильского израильских израильским израильскими
армия: армия армии
издавать: издавать
уведомление: уведомления
особо: особо
израиль: израиль израилем израиле израиля
препятствовать: препятствовать препятствуют препятствуя
порядок: порядка порядок порядке
гражданский: гражданской гражданским гражданского гражданское гражданских гражданскую гражданская гражданские
полиция: полиции полиция полицией
затруднять: затрудняет
убить: убили убив убитых убил убитого убиты
охранник: охранников
суббота: субботу субботе
мародер: мародеры
напасть: напали
колонна: колонну
грузовик: грузовиков грузовики
захватить: захватили захваченных
река: реки
иордан: иордан
нарушение: нарушения нарушение нарушением нарушений нарушениями
вне: вне
безоружный: безоружных безоружными
внесудебный: внесудебные
казнить: казни
разыскивать: разыскиваемых
выселение: выселения
снос: снос
поселение: поселений поселения
жесткий: жесткие жесткое жесткого жестких
передвижение: передвижение передвижения
разрушение: разрушение разрушениям разрушения
подавление: подавление
свобода: свободы свободу
пресс: прессы
мнение: мнений мнения мнению мнение
рейдовый: рейдов
четыре: четырех четыре
восемь: восьми восемь
десять: десяти
авиаудара: авиаудара
таммуне: таммуне
пятница: пятницу
поселенец: поселенцы
атаковать: атаковали
деревня: деревень деревне деревнях деревни
поджечь: подожгли
автомобиль: автомобили
ранить: ранив
вооруженный: вооруженные вооруженных вооруженными
обстрелять: обстреляли
недалекий: недалеко
трое: троих
израильтянин: израильтян
событие: события событиях событий
прозвучать: прозвучавшие прозвучали
дженин: дженин
гибель: гибели гибель
отец: отец
сын: сын
застрелить: застреленные застрелен
отрицать: отрицают
причастность: причастность
трагедия: трагедии трагедией
параллельно: параллельно
выражение: выражения
трансляция: трансляций
альджазиры: альджазиры
критика: критики
арест: аресты
активист: активистов активисты активист
переохлаждение: переохлаждения
ночное: ночные ночными
удар: удары удар удара ударов
ханюнису: ханюнису
альмаваси: альмаваси
адекватный: адекватного адекватную адекватных
жилье: жилья жилье
сочетание: сочетании
зимний: зимними зимние зимнего зимнее зимней
импровизированный: импровизированных
палатка: палатках
сообщаться: сообщается
гипотермия: гипотермии
суровый: суровые суровый
подвергать: подвергают подвергает
сопутствовать: сопутствующими сопутствующих
освободить: освободить
потерять: потеряно потеряли потеряла потерять потерянных
поколение: поколение поколениями поколения поколениям
дегуманизация: дегуманизация
углубление: углубление
катастрофический: катастрофические катастрофических катастрофической катастрофического
фаос: фаос
камбу: камбу
домашний: домашней домашнее домашнем
птица: птицей птицами птиц птицы
инфицированный: инфицированного инфицированными инфицированные инфицированной инфицированных инфицированный
общественность: общественности общественность
минимальный: минимальной минимальными
маргарета: маргарет
харрис: харрис
скончаться: скончавшийся скончались
луизиане: луизиане
старший: старше старший старшего
домашние: домашними домашних домашние
дикий: дикими диких дикой
уточнить: уточнила
десяток: десятков
преимущественный: преимущественно
фермер: фермеры фермеров
распространиться: распространился распространилась распространились распространившуюся распространившейся
акцент: акцент
сельский: сельского сельской сельских сельском сельским
хозяйство: хозяйства хозяйству хозяйстве
метапневмовирус: метапневмовирус
сезонный: сезонное сезонным сезонного
соответствовать: соответствует
ожидание: ожиданиям ожидания ожидании ожиданием
сезон: сезона сезон
загруженность: загруженность
аналогичный: аналогичный аналогично аналогичных аналогичным
никакой: никаких никакой
метапневмовируса: метапневмовируса
впервые: впервые
давно: давно
циркулировать: циркулирует циркулирующей
объяснить: объяснила объяснил объяснить
схожий: схожие
простуда: простудой простуду простуда
протекать: протекать протекает
ношение: ношение
мытье: мытье мытья
рука: рук руки руках
мыть: мойте
медучреждение: медучреждения медучреждений
рассадник: рассадником
знать: знать знают знали знал знай знаю знает знала
оонц: оонц
чжан: чжан
носить: носите носят носит носить ношу
скопление: скопления
плохо: плохо
проветривать: проветриваемых проветривать
аэропорт: аэропорт аэропорты
шэньчжэнь: шэньчжэнь
интенсивность: интенсивность интенсивности
государствамичленами: государствамичленами
прозрачный: прозрачной
коммуникация: коммуникации коммуникациям
противодействовать: противодействовать
ложный: ложным ложная ложной
сведение: сведениям
конечный: конечном
легкое: легкие легких легкое
кашель: кашель
заложенность: заложенность
нос: носа
хрип: хрипы
воздушнокапельным: воздушнокапельным
поверхность: поверхности
специфический: специфической
противовирусный: противовирусной противовирусные противовирусным противовирусных
применимый: применимы
прикрывать: прикрывайте
рот: рот
кашлять: кашляете
чихать: чихаете
салфетка: салфеткой
согнутый: согнутым
локоть: локтем
регулярно: регулярно
очищать: очищайте
кислород: кислорода
ежедневно: ежедневно
уносить: уносит уносят
туркменистан: туркменистан туркменистане
увкпчвтремо: увкпчвтремо
диана: диана дианы
жалба: жалба
считать: считает считают считая
любить: любит люблю любят любила
позволять: позволять позволяют позволяющие позволяет позволяющими позволяющее
подвижной: подвижная
разговорчивый: разговорчивая
церебральный: церебральным
паралич: параличом паралич паралича
нравиться: нравится нравилось
квартира: квартире
ходить: хожу ходить
кино: кино
хотеться: хочется
объяснять: объяснять объясняет объясняя
стажировка: стажировки стажировка
инклюзивность: инклюзивность
принадлежать: принадлежащих принадлежит
дискриминация: дискриминацией дискриминации дискриминация
наставник: наставниками
стажер: стажеры
приобретать: приобретают
профессиональный: профессиональные профессиональном профессиональной профессиональную профессиональный
навык: навыки навыкам навыков
трудоустройство: трудоустройства
личной: личном личную личной личные личного личная
магистр: магистра
языковый: языков
литература: литературы
девушка: девушка девушку девушках девушек
переводчик: переводчиком
нпо: нпо
научиться: научилась научиться научился
справляться: справляться справляются
эмоция: эмоциями эмоции эмоциях
фокусироваться: фокусироваться
хотеть: хочу хотим хотел хотят хочет хотели хотите хотела
печатать: печатаю
голосовой: голосовую
точность: точность
запятая: запятую
придирчивый: придирчивой
доверять: доверяю
добавлять: добавляет добавляют
смеяться: смеется
инвалид: инвалидов инвалиды инвалидами
ратификация: ратификация
законодательный: законодательным законодательных законодательном
завершение: завершения завершению завершение завершением
множество: множество множеством множества
занятость: занятости занятостью
составлять: составляет составляют составлял
местность: местности
бедность: бедности
изоляция: изоляции изоляцией изоляцию
наставница: наставницей
ксения: ксенией ксения
симинчук: симинчук
достойный: достойную
независимый: независимую независимый независимого независимых независимые
наравне: наравне
близкие: близкими близких близкие
подруга: подругами
жалбе: жалбе
грамотный: грамотное грамотными
резюме: резюме
собеседование: собеседованию
народный: народного
адвокат: адвоката адвокатов
рассматривать: рассматривать рассматриваем
соавтор: соавторов соавтор
культурный: культурной культурные культурных
василь: василе
кушка: кушка кушки
труд: труда
учебный: учебных учебные учебного учебный
заведение: заведений заведения
одноименный: одноименную
деинституционализации: деинституционализации
взаимодействовать: взаимодействует
инклюзивности: инклюзивности
пересмотр: пересмотра
стереотип: стереотипами стереотипах стереотипы
убеждение: убеждениями
людмила: людмила людмилы
адамчук: адамчук
дочка: дочкой дочки
беатрис: беатрис
менталитет: менталитет
семилетней: семилетней
синдром: синдром
дауна: дауна
активистка: активистка активисткой
основать: основала основана основанный основанной основанном
румынский: румынском
осведомленность: осведомленность осведомленности
слышать: слышим слышит слышат слышала
предлог: предлогом
квалифицированный: квалифицированного квалифицированную
пример: примеры примером примеру примерам
квалификация: квалификацию квалификации квалификация
супруг: супруги супруга
валерий: валерий
шемянский: шемянский
федотов: федотова
родиться: родившийся родился
приднестровье: приднестровье
юридический: юридические юридическая юридической юридических
пар: пара
оптимизировать: оптимизировать
дефакто: дефакто
нормативный: нормативную
льгота: льготами льготы
остальное: остальных
южет: южет
травля: травли
заместительный: заместительная
наркозависимости: наркозависимости
тюрьма: тюрьмах тюрьме тюрьмы
подорвать: подорвет
юнфпаукраина: юнфпаукраина
юнфпа: юнфпа
фронт: фронта
народонаселение: народонаселения
психосоциальную: психосоциальную
пространство: пространствами пространства пространство пространствах
поезд: поезда
держать: держа держать
сумка: сумку
спасаться: спасается спасаясь
российский: российских российской
запорожский: запорожской запорожскую
жестокий: жестокого жестоких жестокому
однажды: однажды
избить: избил
случиться: случился случившееся
выкидыш: выкидыш
искать: ищет ищем
встретить: встретили встретить
вокзал: вокзале
татьяна: татьяна
психолог: психолог психологу
сопровождение: сопровождение сопровождения
документ: документами документов документ документе
украинка: украинкам украинок
беда: беду
находить: находить
возникнуть: возникших возникшую возникшие возникла
устроиться: устроиться устроился
миновать: миновала
травмировать: травмированы
вторжение: вторжения вторжение
назад: назад
интимный: интимного интимные
сексуальный: сексуальном сексуального сексуальное сексуальной сексуальному сексуальная сексуальных сексуальным сексуально сексуальную
обрести: обретя
панический: паническими
депрессия: депрессии депрессию депрессией депрессия
ощущать: ощущают ощущаю ощущать
тревога: тревогу тревоги тревога тревогой
стресс: стресса стрессом стресс стрессу
заботиться: заботиться
страх: страх
страдание: страдания страданиям
надлежащий: надлежащей надлежащего
ощущаться: ощущаться ощущается
широкомасштабный: широкомасштабное
выжить: выжить
роман: роман романа
сразу: сразу
род: рода роду
добляет: добляет
стабильный: стабильного стабильных стабильной стабильным стабильном
поставить: поставила поставил поставлены поставленную поставили поставить
эксплуатация: эксплуатации
думать: думают думал
выживание: выживание
исцеление: исцеление
зачастую: зачастую
родные: родных
обратиться: обратиться обратилась обратились обратился
прибегать: прибегает
прибывать: прибываем прибывали
раскачка: раскачку
включаться: включаемся включается включаются
начинать: начинаем начиная начинать начинал начинали начинает начинают
просто: просто
задумываться: задумываться задумывается
оглядываться: оглядываемся
понимать: понимаем понимали понимал понимает понимать понимала
дело: деле делам
нападение: нападений нападение нападениях нападения нападению нападениям
медперсонал: медперсонал
критически: критически
нелегко: нелегко
становиться: становится становятся становились
настраиваться: настраиваемся
отложить: отложить отложена
финансировать: финансирует финансируемыми финансируют финансировать
психосоциальных: психосоциальных
слой: слоям слоев слои
городской: городские городских городского
переселение: переселений переселения
жизнестойкость: жизнестойкость
решающий: решающее решающим
неопределенность: неопределенности неопределенность неопределенностью
перспектива: перспективы перспективе перспективах
лишиться: лишиться
азбука: азбуки азбука
брайль: брайля
оонрбаджорнас: оонрбаджорнас
инструмент: инструментов инструментам инструментом
слепой: слепым слепые слепых
слабовидящий: слабовидящим слабовидящие
зрение: зрения
далеко: далеко
нередко: нередко
извне: извне
какойлибо: какойлибо
близорукость: близорукость
дальнозоркость: дальнозоркость
легко: легко
исправить: исправить
очки: очков
контактный: контактных
линза: линз
собственный: собственной собственных собственно
комбинация: комбинации
точка: точек точки точке точках
буква: буквы
алфавит: алфавита
музыкальный: музыкальные
математический: математические
символ: символы
разный: разных разным разного разной разные
знакомиться: знакомиться знакомятся
книга: книг
газета: газет
избирательный: избирательных
бюллетень: бюллетеней
преодолевать: преодолевая преодолевать
узбекистан: узбекистана узбекистане узбекистан
утопление: утопления утоплений утопление утоплениям
очередной: очередной
северовостоке: северовостоке
сирийский: сирийском сирийскую сирийскими
альхоль: альхоль
свержение: свержения
асад: асада
альхоле: альхоле
жена: жены женами жена
боевик: боевиков боевики
игил: игил
вовлечь: вовлеченными
разразиться: разразилась
репрессия: репрессий
мирный: мирных мирному
демонстрант: демонстрантов
впоследствии: впоследствии
водянистый: водянистой
максимальный: максимального максимальной
шаткий: шаткую
хурчид: хурчид
хасана: хасан
отдать: отдал отдать
должное: должное
временной: временному временных временные временными
дамаск: дамаске
транспортировка: транспортировку транспортировка
ворот: воротам
альхоля: альхоля
курд: курдами
возвращаться: возвращается возвращаются
лагерь: лагерь лагеря лагерях
совершить: совершено совершенным
вакцинаторов: вакцинаторов
проделывать: проделывают
спасительный: спасительную
ухаживать: ухаживает ухаживающих
перевезти: перевезло
северозапада: северозапада
оценить: оценил оценить
доверие: доверия доверие доверию
нарастить: нарастить
побороть: побороть
юнисефабабаджанян: юнисефабабаджанян
продолжительный: продолжительная продолжительные
сахара: сахары
юговосточной: юговосточной
вероятность: вероятность
вовремя: вовремя
распознать: распознать
необычный: необычные
кровотечение: кровотечения
менструация: менструациями менструация менструацией менструации менструаций
менопауза: менопаузы менопаузе менопауза менопаузу менопаузой
акт: акта
обильный: обильные
выделение: выделения
влагалище: влагалища влагалище
неприятный: неприятные неприятных
ощущение: ощущения
боль: боль боли болью болями
спина: спине
нога: ногах ног ноги
таз: таза
аппетит: аппетита
усталость: усталость усталости
отек: отеки
незамедлительно: незамедлительно
осмотр: осмотры осмотр
вичинфекцией: вичинфекцией
предраковых: предраковых
прежде: прежде
распространенность: распространенность распространенности
раковый: раковых
мужской: мужское мужская
обрезание: обрезание
презерватив: презервативы презервативов презерватив
диагноз: диагноза диагноз
излечимый: излечимых излечимые
выявляться: выявляется
лечиться: лечится
скрининг: скринингу скрининг скрининга
взяться: взяться
мучительный: мучительную
оонмир: оонмир
совершенно: совершенно
возкмалиро: возкмалиро
послание: послании посланием послание
противоэпидемический: противоэпидемической
пошатнуть: пошатнула
перегрузка: перегрузке
перевернуть: перевернула перевернуло
повседневный: повседневную повседневной
антониу: антониу
гутерриш: гутерриш
марбургский: марбургской
пугать: пугающими
напоминание: напоминаниями напоминанием
реально: реально
извлечь: извлечь извлеченные
первичный: первичной первичного
медикосанитарной: медикосанитарной
обещание: обещания
равный: равного равному равный равных
солидарность: солидарность солидарности
выполнить: выполнить выполнена
повсюду: повсюду
обеспокоить: обеспокоены
мюнхен: мюнхене
паника: панике паники
слух: слухам слух слуха
противопоставить: противопоставить
медитация: медитации медитация медитаций
чгейтс: чгейтс
кровяной: кровяное
тревожность: тревожность
эмоциональный: эмоциональному эмоционального эмоциональными эмоциональное эмоциональные эмоциональным
самосознание: самосознание
улучшать: улучшает улучшаем
сон: сон
провозгласить: провозгласила провозгласили
признанный: признанное
описывать: описывает описывать
техник: техники
осознанность: осознанность осознанности
концентрация: концентрация концентрации
тренировка: тренировки
ум: ума
ясность: ясности
разум: разума
спокойствие: спокойствия
расслабление: расслабления
равновесие: равновесия
мощный: мощным мощных
самопомощь: самопомощи
самочувствие: самочувствия самочувствие самочувствии
медитировать: медитируют
онлайнплатформы: онлайнплатформы
практиковать: практиковать
индивидуальный: индивидуальных индивидуальной индивидуальном индивидуальный индивидуального
эмпатия: эмпатии
чувство: чувства чувстве чувствах чувство
коллективный: коллективному коллективной коллективного
универсальность: универсальность
практиковаться: практикуется практиковались
занимать: занимает занимать
что: чему
комната: комната комнате
дага: дага
хаммаршельда: хаммаршельда
тишина: тишины тишине
символизировать: символизирует
самоанализа: самоанализа
гармония: гармонии
предназначить: предназначенном предназначен предназначенные предназначены
дискуссия: дискуссий
благой: благо
посвятить: посвященная посвятить посвященный посвящен посвященное посвященным
смысл: смысле смысл
неподвижность: неподвижности
разговаривать: разговаривать
фаоджнаполитано: фаоджнаполитано
млекопитающее: млекопитающих млекопитающим
молочный: молочного
керхове: керхове
австралия: австралии
канада: канаде
камбоджа: камбодже
ферма: ферм
оцениваться: оценивается оцениваются
умеренный: умеренный
комбинезон: комбинезоны
глаз: глаз глазом
перчатка: перчатки
обувь: обувь
адаптироваться: адаптировались адаптироваться
эпидемиологический: эпидемиологическими эпидемиологическая эпидемиологические
вирусологический: вирусологическими
серологический: серологическими
помнить: помнить помня
измениться: измениться изменилось изменившимся изменилась изменится
эволюционировать: эволюционировать
сценарий: сценарию
континент: континентах континенте континентов континента континент
охрана: охране охрана охраны
грегорио: грегорио
торрес: торрес
руководитель: руководитель
признак: признаков признаку
мадхур: мадхур
дхингра: дхингра
высокопатогенного: высокопатогенного
птицеводческий: птицеводческую
прямой: прямого прямо
существование: существованию
биобезопасности: биобезопасности
отразиться: отразилось
исчезновение: исчезновения
калифорнийский: калифорнийский
кондор: кондор
белые: белые
медведь: медведи
биоразнообразие: биоразнообразие
морской: морских
экосистема: экосистем экосистемы
антарктика: антарктики
беспокойство: беспокойство
сибирский: сибирской сибирских
пост: поста пост
визит: визита визиты визит
днепропетровск: днепропетровске днепропетровск
бельгиец: бельгиец
охватывать: охватывающее охватывает
гренландия: гренландии
владивосток: владивостока
заместитель: заместителю заместитель
мелисса: мелиссе
флеминг: флеминг
подкаста: подкаста
сибирь: сибири
повлиять: повлияла повлиять повлияло
любовь: любовь любви
картошка: картошка картошку
католический: католических
традиция: традициях традиций традиции
изначально: изначально
миссионер: миссионера
уголок: уголках уголке
отказаться: отказаться
романтический: романтических
молодой: молодого молодому
перебор: перебором
вместо: вместо
миссионерский: миссионерской
итог: итоге итоги итогом
будущий: будущий будущей
влюбиться: влюбился
английский: английского
универсальный: универсальный
вспоминать: вспоминает
бабушка: бабушка бабушкой
дедушка: дедушка
екатерина: екатерины екатериной екатерина
годовщина: годовщину
свадьба: свадьбы
поначалу: поначалу
немецкий: немецкого
шпион: шпиона
студентка: студентка
томский: томского
университет: университета университете университет
жила: жила
расположить: расположенной расположена расположенный
заслужить: заслужить
вскопать: вскопать
оправдать: оправдал
окончание: окончания окончание окончанием
контракт: контракта
московский: московское
представительство: представительство представительства
показать: показала показано
особенность: особенности
слушать: слушать
обстоятельство: обстоятельствах обстоятельства
возюкочкин: возюкочкин
москва: москве
бок: бок
понимание: понимание пониманию
строить: строить
мьянма: мьянме мьянма
кндр: кндр
корея: корее
везде: везде
занять: занял
относительно: относительно
спокойный: спокойным спокойно
повестка: повестки повестку
газа: газой
усложнять: усложняет
кандидат: кандидатом кандидат
побывать: побывал побывать
марафон: марафонах
длинный: длинный
забег: забег
мой: моей мое моему моим мои моими моего
актуальный: актуален актуальна актуальную актуальная актуальны
проблематичный: проблематично
богатый: богатых богатые
интерес: интересам интересах интерес интересы
сложно: сложно
поведенческий: поведенческие
пятый: пятый пятого
одинокий: одинокими
одиночество: одиночество
невидимый: невидимый
убийца: убийца
стигматизация: стигматизация стигматизацией стигматизации стигматизацию
препятствие: препятствием препятствий препятствия препятствиями
сосед: соседям соседи
уязвимость: уязвимости
осознание: осознание
значимость: значимости значимость
базовый: базовых базовым базовые базовыми базовой базовую базовый
уметь: уметь
наука: науке наук
видимый: видим
называть: называемых называемую называют называемого
нулевой: нулевых
хранить: хранить
избыток: избыток
мечта: мечта
ориентация: ориентации ориентация
переломный: переломного переломном переломный
доминировать: доминировать
дельта: дельта
паэс: паэс
плавание: плаванию плавания плавание
немой: нем
тонуть: тонут
присмотр: присмотра
отличный: отличная
доказательство: доказательство доказательства доказательств
сработать: сработали сработало
избежать: избежать
африканский: африканском африканского африканских африканскую африканские
майкл: майкл
блумберг: блумберг
посол: посол
основатель: основатель
мэр: мэр
ньюйорка: ньюйорка
забывать: забывать забывайте
тенденция: тенденции тенденций тенденцию тенденция тенденцией
сохраниться: сохранятся
ограждение: ограждений ограждении
вокруг: вокруг
обязательный: обязательное обязательного обязательные обязательным
игровой: игровых
вдали: вдали
реанимация: реанимации
лодка: лодках
поисковоспасательные: поисковоспасательные
реализовать: реализуют реализовать
включить: включено включенный включить
школьный: школьные школьного
спасательный: спасательных
жилет: жилетов
прогулочный: прогулочных
точный: точная точные точное точном точную
днем: днем
юнисефамэльфати: юнисефамэльфати
расчет: расчете
душ: душу душах души душе душ
приурочить: приуроченном приурочен
расширяться: расширяется расширяются
черта: чертой
прямая: прямыми прямой прямых
основополагающий: основополагающим
ограничиваться: ограничиваются ограничивается
платеж: платежи платежами платежей
свыше: свыше
продемонстрировать: продемонстрировало продемонстрировать продемонстрированы
профилактический: профилактических профилактическую профилактическим профилактические
схема: схемами схема
отслеживать: отслеживает отслеживать отслеживала
содержать: содержащей содержит содержащим содержать содержат
публикация: публикация публикации
общедоступный: общедоступные
прозрачность: прозрачности
подотчетность: подотчетности
лион: лионе
собираться: собираются собирались
советник: советники советника советник
этап: этап этапа этапы этапе этапов
пообещать: пообещали
удвоить: удвоить
саммит: саммит саммите саммита
слуховой: слуховые
стоматологический: стоматологическую
домохозяйство: домохозяйств домохозяйство
слишком: слишком
трата: тратами
отопление: отопление отопления
преддверие: преддверии
воуз: воуз
выбирать: выбирать выбирайте
оплата: оплатой оплаты
удовлетворение: удовлетворением
еда: еда
факт: факты факт фактах
чаща: чаще
испытывать: испытывают испытывает испытываем
аналитик: аналитиков
правозащитный: правозащитных правозащитному
фактический: фактические фактическую
обнищание: обнищанию
грань: грань
нищета: нищеты
наташа: наташа
аззопарди: аззопарди
мускат: мускат
ерб: ерб
повторять: повторять
ошибка: ошибок
ноль: ноль
эаунуабона: эаунуабона
демонстрация: демонстрация демонстрацией
лондон: лондоне
продуктивный: продуктивную
идея: идеи идея идей
сострадание: сострадания сострадание
устойчивость: устойчивости устойчивость устойчивостью
достоинство: достоинство
лишить: лишен лишена лишенными
речь: речь
идти: идет идти
маргинализированных: маргинализированных
стигма: стигмой стигма стигму
кристина: кристин
штеглинг: штеглинг
криминализация: криминализацией криминализацию
недооценить: недооцененными
недостаток: недостаток
объединиться: объединиться
вичспид: вичспид
альянс: альянс
покончить: покончить
юнисефмнафталин: юнисефмнафталин
название: названием название
генетический: генетических генетические генетическая генетическим
маркер: маркеров
бактерия: бактерии бактерий бактерия бактериями
слюна: слюне
подозрение: подозрением подозрения
подобный: подобный подобных подобная подобные подобным подобного
строгий: строгую строгие
проверка: проверку проверка
закупать: закупать
знаменовать: знаменует
помощник: помощник помощника
юкико: юкико
накатани: накатани
идентифицировать: идентифицировать
мутация: мутации мутаций
противотуберкулезный: противотуберкулезным противотуберкулезное
рифампицин: рифампицин
бедаквилин: бедаквилин
фторхинолоны: фторхинолоны
либо: либо
лекарственноустойчивых: лекарственноустойчивых
высококачественный: высококачественные
преквалификации: преквалификации
рожерио: рожерио
гаспар: гаспар
преквалификация: преквалификация
прокладывать: прокладывает
двойной: двойного двойной двойные двойных
бременить: бремени
обзор: обзоре
сингапур: сингапура
множественный: множественной множественными множественные
мремес: мремес
подростковый: подростков подростковой подросткового подростковую подростковом подростковых
государствахчленах: государствахчленах
общепризнанный: общепризнанный
гален: гален
галеа: галеа
подпитываться: подпитывается
антитабачный: антитабачной
действовать: действовать действовавших
поновому: поновому
неоднозначный: неоднозначный
приниматься: принимаются
облагаться: облагаются
налог: налогами налог налога
ценовой: ценовая
предоставляться: предоставляется
стимулирование: стимулирование стимулирования
продажа: продаж продажа
планомерно: планомерно
двигаться: движутся
предполагаться: предполагается
запланировать: запланированные запланированных запланированная
едва: едва
какихлибо: какихлибо
пристраститься: пристрастились
минздрав: минздрав минздрава
наградить: награжден
медаль: медалью
юнисефдж: юнисефдж
пироцци: пироцци
вичположительная: вичположительная
рисовать: рисует
ташкент: ташкенте
заметный: заметное
тинейджер: тинейджеры тинейджеров тинейджерами
девочкамподросткам: девочкамподросткам
тропический: тропической
инфицировать: инфицированы
достигать: достигает
анурита: анурита
бейнс: бейнс
подросток: подростки подростка подросток подростком подросткам подростками
плод: плодами плоды плода
инвестирование: инвестировании
пояснить: пояснила пояснил пояснили
курс: курс курсы курсах курса
возрастной: возрастной возрастных
вичпозитивных: вичпозитивных
антиретровирусную: антиретровирусную
воодушевлять: воодушевляющие
сентвинсент: сентвинсент
ботсвана: ботсвана
сертифицировать: сертифицированы
уважение: уважению уважения
существенный: существенного существенны существенных существенные
дискриминационный: дискриминационные
наказание: наказания
меньшинство: меньшинств
проверить: проверенным проверить проверено
слоган: слоган
правильный: правильный правильной
прислушаться: прислушаться
пойти: пойти пойду
подытожить: подытожил
обсудить: обсудили
равноправие: равноправие
пятилетняя: пятилетняя
антоний: антония антонии антонию
госпитализировать: госпитализирована госпитализировали госпитализированных
сидеть: сидит сидеть
улица: улице улицу
спрашивать: спрашивает спрашивали
завтра: завтра
избегать: избегать избегайте
выписка: выписки
дорогостоящий: дорогостоящий дорогостоящих
подняться: поднялась
судорога: судороги
подумать: подумала подумал подумали
предотвратимый: предотвратимых
овидиу: овидиу
эмилиан: эмилиан
бибире: бибире
семейный: семейный семейной
община: общине общины общинах община общин
корбаска: корбаска
воспитание: воспитания воспитании воспитание воспитанию
недоверие: недоверие недоверием
сесилия: сесилия
лукач: лукач
бакэу: бакэу
подозрительный: подозрительное
коклюш: коклюшем коклюша
дифтерия: дифтерии
столбняк: столбняка
акдс: акдс
краткосрочный: краткосрочной
лэкрэмиоара: лэкрэмиоара
вранчану: вранчану
посещать: посещает посещаю посещать
консультировать: консультирую консультируют
лэкрэмиоары: лэкрэмиоары
корбаске: корбаске
пилотирование: пилотирование
интегрировать: интегрированных
флагманский: флагманской
опекун: опекунов
физиотерапия: физиотерапию
логопед: логопедов
родительский: родительских
семинар: семинарах семинары семинаров семинара
прочий: прочего
рассказываться: рассказывается
знакомство: знакомству
лэкрэмиоарой: лэкрэмиоарой
определиться: определилась
профессия: профессией профессии
секунда: секунд
барселона: барселоне
всерьез: всерьез
юнисефоасселен: юнисефоасселен
накануне: накануне
озаглавить: озаглавленный
выбрать: выбрать
безнаказанность: безнаказанность
арестовывать: арестовывают
кто: кем кого кому
инфицироваться: инфицируются
сверстниковмужчин: сверстниковмужчин
движение: движения движении
номонде: номонде
нгема: нгема
обращать: обращает обращают обращая
однополые: однополые
криминализованы: криминализованы
лгбтсообществ: лгбтсообществ
карательный: карательные
удерживать: удерживают
аксель: аксель
баутиста: баутиста
наказывать: наказывать
маргинализированные: маргинализированные
иновации: иновации
зависеть: зависит зависим
спасать: спасают
александр: александра александр
калми: калми
жанна: жанна
гапиянийонзима: гапиянийонзима
основательница: основательница
бурунди: бурунди
публичный: публично
вичположительном: вичположительном
эссе: эссе
элтон: элтон
джон: джон
архиепископ: архиепископ
кейптаун: кейптауна
табо: табо
макгоба: макгоба
хиггинс: хиггинс
вдохновлять: вдохновлять
нуль: нулей нуля
подавить: подавленную
хурскин: хурскин
медик: медики медиками медикам
союз: союза союз союзе
кадровый: кадров кадровый кадрового кадровое
презентация: презентации
киев: киеве
аззопардимускат: аззопардимускат
возевропа: возевропа
преподаватель: преподавателей преподаватели преподаватель
фундамент: фундамент
дисбаланс: дисбаланс дисбаланса
подчеркиваться: подчеркивается подчеркиваются
совершенствование: совершенствование
стимул: стимулов
наем: найма
стратегический: стратегическое стратегических стратегические стратегическом
планирование: планирование планирования планированию
прогнозирование: прогнозирования
кадры: кадрах кадры
миграция: миграция миграции
численность: численности
настоятельный: настоятельную
построить: построить построила построены
старение: старение старения старению
капитал: капитала
вскоре: вскоре
пенсия: пенсию пенсии
демографический: демографический
сдвиг: сдвиг
обслуживать: обслуживают
плотность: плотность
покидать: покидает покидают покидать
когото: когото
заразить: заражу зараженную зараженного зараженных
итальянский: итальянская
проявлять: проявлять проявляют
доброта: доброту
расстояние: расстоянии
юмор: юмор
виртуальный: виртуального
концерт: концерта
медиков: медиков
увкбхборразас: увкбхборразас
пригород: пригороде
бейрут: бейрута бейруте
объект: объекты объектов объект объекта
боевой: боевые
среднемировой: среднемировой среднемировых
опт: опт
очевидно: очевидно
лишение: лишение
преследование: преследование
абдинасир: абдинасир
абубакар: абубакар абубакара
восстановиться: восстановиться
грозить: грозит
участь: участь
вопервых: вопервых
вовторых: вовторых
последующий: последующие последующего
материнский: материнского материнской
репродуктивный: репродуктивного репродуктивной репродуктивном репродуктивному репродуктивный
диагностирование: диагностированию
десятая: десятая
многочисленный: многочисленных многочисленным
частично: частично
набатия: набатия
больничный: больничных
койка: коек
миротворец: миротворца миротворцев
всоонл: всоонл
ракета: ракеты
штаб: штаб
шаме: шаме
италия: италии
счастье: счастью
хезболлой: хезболлой
группировка: группировками
бункер: бункер
близлежащий: близлежащей
третье: третье третьего
настоятельно: настоятельно
вблизи: вблизи
миротворческий: миротворческих миротворческие
соблюдаться: соблюдаться
преднамеренно: преднамеренно
снести: снесла
осуждать: осуждают
преступление: преступление преступлением
джидда: джидде джидды джидда
антибиотик: антибиотикам антибиотики антибиотиков антибиотиками
саудовский: саудовской
аравия: аравии
антимикробный: антимикробной антимикробную
резистентность: резистентности резистентностью резистентность
министерский: министерская
противомикробный: противомикробным противомикробные противомикробных противомикробная противомикробными противомикробной
упп: упп
фахад: фахад
альджаладжел: альджаладжел
строительный: строительные
блок: блоки
основываться: основываются
четырехстороннего: четырехстороннего
состав: состав составе
юнеп: юнеп
воозж: воозж
биотехнологический: биотехнологического
мост: моста
инновация: инноваций
микроб: микробы
развивать: развивают развивать
побеждать: побеждать
уничтожение: уничтожения
жаклин: жаклин
альварес: альварес
итоговый: итоговый
многосторонний: многостороннего
оставить: оставить оставили
позади: позади
джарриел: джарриел
открыться: открывшемся
супербактерий: супербактерий
убежденный: убежден
согласовать: согласованная согласованных согласованные согласована
устанавливать: устанавливает
воплотить: воплотить воплощены
задумать: задуманное задумали
конкретный: конкретные конкретным конкретных конкретный конкретного
активизация: активизация активизацией
грибок: грибки грибков
переставать: перестают
неэффективный: неэффективными
арсенал: арсеналом
воспользоваться: воспользоваться
подвести: подвел подвести
собраться: собравшиеся собравшийся соберется
камарго: камарго
напиток: напитков напитки напитками
содержание: содержанием содержания
сахар: сахара сахар
полумиллиона: полумиллиона
сахарный: сахарным сахарного
готовить: готовят готовит готовить готовили
репортаж: репортаж репортажей
казахстанский: казахстанского казахстанские
изучение: изучению
жанай: жанай
аканов: аканов
умножать: умножать
пятьшесть: пятьшесть
казахстанец: казахстанцев казахстанцы
углеводный: углеводным
тучный: тучных
аканова: аканова
эндокринолог: эндокринологи эндокринологов
фиксировать: фиксируют
ожидать: ожидаем ожидал ожидаемая ожидаемого
диабетик: диабетиков
жанаем: жанаем
акановым: акановым
благополучный: благополучным
собеседник: собеседник
затрата: затраты
бесплатно: бесплатно
легкомысленный: легкомысленное
пренебрежительный: пренебрежительного
халатность: халатность
легкомыслие: легкомыслие
нормальный: нормального нормальной нормальная
кровь: крови кровь
категория: категория категорий
ссылаться: ссылается ссылаясь
придерживаться: придерживаться
диета: диеты
спорт: спортом спорта спорте
гулять: гулять
игнорироваться: игнорируются игнорируется
стол: стол
инфаркт: инфарктом
инсульт: инсультом инсульта
гангрена: гангреной
нижний: нижних нижней
конечность: конечностей конечности
угодно: угодно
поздно: поздно
обвинять: обвиняют
ампутация: ампутации ампутаций
лишаться: лишаются
япония: японии япония
теория: теорий
эволюция: эволюции
вернее: вернее
натуральный: натуральные
редко: редко
консервы: консервы
генетически: генетически
рано: рано
инсулин: инсулина инсулин
очистки: очистки
прорывной: прорывных
количество: количества количество количеством количестве количествах
консервированный: консервированных
гликемическим: гликемическим
индекс: индексом индекс
набор: набором набор наборов
пошло: пошло
вверх: вверх
столетие: столетия столетие
вина: виной
генетик: генетика
комфорт: комфорт
вредный: вредные вредных
объяснение: объяснение
заключить: заключил
лаура: лаура
утемисова: утемисова
диабетический: диабетическая диабетическую
настороженность: настороженность
преддиабет: преддиабет
применяться: применяется
ставиться: ставится
сформировать: сформировать сформировал
патологический: патологическое
стоматолог: стоматолог
выпадать: выпадают
зуб: зубы
десна: десен
обязательно: обязательно
отправить: отправить отправила отправлены
гинеколог: гинекологи
уролог: урологи
наготове: наготове
доводить: доводя
превентивный: превентивные
литровый: литров
сахаросодержащий: сахаросодержащих сахаросодержащие
касательно: касательно
фальсификация: фальсификации
оземпик: оземпик
геймер: геймеров геймеры
видеоигра: видеоигры видеоигр
тендонг: тендонг
звуковой: звукового
громкость: громкости громкость
компьютер: компьютерах компьютеров
приставка: приставках
телефон: телефонах телефонов телефонами
прослушивание: прослушивания
электросвязь: электросвязи
мсэ: мсэ
жером: жером
саломон: саломон
киберспорт: киберспорт
развлеченье: развлечений
худой: хуже
переносить: переносят переносить переносила
громкий: громкие
звук: звуки звука звук
информировать: информировать информированы
частное: частному частные частное
киберспорта: киберспорта
контент: контенту
пользователь: пользователей пользователя пользователям пользователи
сейдзо: сейдзо
оноэ: оноэ
стандартизация: стандартизации
консоль: консолей
наушник: наушников наушниками
гарнитур: гарнитуры
программный: программного
допустимый: допустимого
встраивание: встраивание
игрок: игрокам игрок
удобный: удобной
регулировка: регулировки
автоматически: автоматически
переключаться: переключается
колонка: колонками
приглушить: приглушите
современный: современном современные
процветать: процветающим
радиоактивный: радиоактивных
ядерный: ядерной ядерными
совбез: совбезе совбеза совбез
кибератак: кибератак
выкуп: выкупа выкуп
хакероввымогателей: хакероввымогателей
частый: частым
хакер: хакер
ведомство: ведомства
согласиться: согласится согласились согласился
заплатить: заплатить
трагический: трагическим трагической
хакерывымогатели: хакерывымогатели
брно: брно
чехия: чехии
подвергнуться: подверглась подверглись подвергшихся подвергнутся подвергшимся
вымогательский: вымогательской
хакерский: хакерской
перевести: перевести
процедура: процедуры процедур
бумагоноситель: бумагоносителях
отправка: отправки
прикрепить: прикрепленным
файл: файлом файла
загрузить: загружена
вредоносный: вредоносная
зашифровать: зашифровала
программывымогатели: программывымогатели
совершаться: совершаются
плохой: худшем плохих плохом худшими плохого худшее плохим
вернуть: вернуть вернуло
злоумышленник: злоумышленники
киберпреступностью: киберпреступностью
исходить: исходя
логика: логики
платить: платить
выплатить: выплатить
гарантия: гарантии гарантий
расшифровать: расшифрованы
повториться: повторится
кибернападений: кибернападений
респондент: респондентов
убыток: убытки
эдуардо: эдуардо
конрад: конрад
программывымогателя: программывымогателя
потратить: потратить
энна: энн
нойбергер: нойбергер
программамивымогателями: программамивымогателями
превысить: превысили превысил превысить превысила
связывать: связывают
василий: василий
небензя: небензя
сомнение: сомнение сомнения
киберпреступность: киберпреступность
вено: вене вену
переговоры: переговоры переговоров
кибербезопасность: кибербезопасность
завершать: завершают завершая
киберпреступности: киберпреступности
оонф: оонф
иса: иса
просьба: просьбой
названый: названы
социальноэкономические: социальноэкономические
давний: давние
стрептококк: стрептококк
срочность: срочность
определяться: определялись
отдача: отдачей
кейт: кейт
обрайен: обрайен
биологический: биологическим биологическими биологических биологические
обширный: обширный
предпочтенье: предпочтений
перечень: перечни
эндемичный: эндемичных эндемичной
исследовать: исследовать исследовала
клебсиелла: клебсиелла
цитомегаловирус: цитомегаловирус
защитный: защитная защитные
нетифоидная: нетифоидная
сальмонелла: сальмонелла
норовирус: норовирус
шигеллы: шигеллы
золотистый: золотистый
стафилококк: стафилококк
денге: денге
внекишечный: внекишечная
патогенный: патогенная
кишечный: кишечная
палочка: палочка
микобактерии: микобактерии
респираторносинцитиальный: респираторносинцитиальный
рсв: рсв
инстаграм: инстаграм
распространять: распространять распространяет распространяют
достоверный: достоверную достоверной достоверных
юный: юных юные
досягаемость: досягаемости
значит: значит
ричард: ричарда
пиперкорна: пиперкорна
приказ: приказов приказы
ближневосточный: ближневосточном ближневосточное ближневосточному
утро: утром утра
минувший: минувшие минувшей минувший
выходной: выходные
расследование: расследование расследованию расследования
вечер: вечером вечера
прекратиться: прекратиться
вписывать: вписывают
мрачный: мрачную мрачным
летопись: летопись
кошмарный: кошмарной
расследовать: расследовать
привлечение: привлечения
трехдневной: трехдневной
искоренить: искорененный искорененной
хамас: хамас
стационарный: стационарных
бомбежка: бомбежек
проявиться: проявиться
медицина: медицина медицины
красота: красоты красота
микропластика: микропластика
косметика: косметике косметика
женский: женской женским женских женские женскими женское женскому
токсичность: токсичностью токсичности
потребительский: потребительских
косметический: косметические косметическими косметических
гигиенический: гигиенические
лежать: лежит
прилавок: прилавках
маркос: маркос
орельяна: орельяна
рассчитать: рассчитаны рассчитанные
утешительный: утешительны
специальный: специального специальный специальные специально специальных
докладчик: докладчика докладчик
ароматизированный: ароматизированные
прокладка: прокладки прокладках
отчасти: отчасти
сексистскими: сексистскими
предрассудок: предрассудками предрассудки
ориентировать: ориентирована ориентированные
андроцентричный: андроцентричный
гормональный: гормональных гормональные
сердечнососудистых: сердечнососудистых
причинять: причиняемый причиняет
повсеместный: повсеместный
разбивка: разбивки
пол: пола пол
пестицид: пестицидами
непреднамеренный: непреднамеренных
отравление: отравлений
известно: известно
склонный: склонны
верить: верить верим
игнорировать: игнорируют
жалоба: жалобы жалобам жалобами
усугубить: усугубленных усугубить
жаловаться: жалующиеся
чувствительность: чувствительность
выражаться: выражающимися
скептический: скептическом скептически
профильный: профильному
сексизма: сексизма
спецдокладчик: спецдокладчик
осведомить: осведомлены
гинекологический: гинекологические гинекологических гинекологический
характеризоваться: характеризуется
тазовый: тазовой
бесплодие: бесплодие бесплодия
эндометриоз: эндометриоз
диоксин: диоксинов
эндометриозом: эндометриозом
терпеть: терпеть
ждать: ждут
поликистоза: поликистоза
эндокринный: эндокринную
поколенье: поколений
фибромиома: фибромиома
фталатами: фталатами
женственность: женственностью женственности
табуируется: табуируется
гениталии: гениталии
кожа: кожа кожи коже кожей
впитывать: впитывающей
менструальный: менструальной менструальных менструальная
эксплуатировать: эксплуатируют
вагинальный: вагинальных
запах: запахах
аромат: ароматы
надумать: надуманной
предлагаться: предлагается
спринцевание: спринцевание
организм: организм организма организме
спринцовка: спринцовок
фталатов: фталатов
свинец: свинец
мышьяк: мышьяк
канцероген: канцерогенами
подсчитать: подсчитали
выделяться: выделяется
наночастиц: наночастиц
пластик: пластика пластиком
трус: трусы
пфас: пфас
переть: пер
полифторалкильные: полифторалкильные
замалчиваться: замалчивается
потребитель: потребители
привлекательно: привлекательно
профессионально: профессионально
молодо: молодо
выглядеть: выглядит
попытка: попытки попыток
осторожность: осторожность
подавляться: подавляются
неуверенность: неуверенности
характерный: характерном характерного
патриархальный: патриархальным
уклад: укладом
усугубляться: усугубляется
маркировка: маркировки маркировка
триклозана: триклозана
парабенов: парабенов
азиатский: азиатских
распрямление: распрямления
волос: волос
формальдегид: формальдегид
канцерогенный: канцерогенным
тринидад: тринидаде
тобаго: тобаго
рецепт: рецепта
кремовый: кремов
осветление: осветления
выясниться: выяснилось
ртуть: ртуть ртути
предельный: предельные
установить: установленные установить установлена установлено установил
минаматской: минаматской
попадание: попадание
дерматологический: дерматологических
нервный: нервных
почка: почками
стимулироваться: стимулируется
закреплять: закрепляющей закрепляет
расистский: расистские
светлый: светлая
считаться: считается считался считалось считаются
привлекательный: привлекательной
компаниипроизводители: компаниипроизводители
выборочно: выборочно
манипулировать: манипулируют
преуменьшить: преуменьшить
спецдокладчика: спецдокладчика
скорректировать: скорректировать
выработать: выработать выработала
рекламный: рекламную
ознакомление: ознакомления
консультироваться: консультироваться
токсин: токсины
микропластик: микропластик
экспедиция: экспедиция
магатэ: магатэ
финальный: финальный
израильгаза: израильгаза
навислый: нависла
луиз: луиза
уотеридж: уотеридж
заключительный: заключительную
фаза: фазу фазы фаза
сутки: суток
гарантированный: гарантированных гарантированным
интенсифицировать: интенсифицировал
перегруппировка: перегруппировки
облегчить: облегчить
нестабильный: нестабильных
царить: царят
нестабильность: нестабильность нестабильности
сомали: сомали
свидетель: свидетелями
возрождение: возрождению
расселл: расселл
рывок: рывок
останавливаться: останавливаться
обезопасить: обезопасим
осада: осаде осады
безопасно: безопасно
добираться: добираться
третий: третий третьей
материальнотехнические: материальнотехнические
полиомиелитный: полиомиелитной
разрешить: разрешены
хиннави: хиннави
возвращение: возвращение
явиться: явилось
побудить: побудило
уменьшать: уменьшает
опасение: опасения
аккаре: аккаре
запуск: запуске запуск
забор: забора
ливанский: ливанские ливанских
перестрелка: перестрелок
исполнять: исполняющий исполняющая
обязанность: обязанности
сложиться: сложился сложившаяся
распределить: распределила распределены
красный: красным красного
крест: крестом
донорство: донорства
хирург: хирургов
тедроса: тедроса
направляться: направляются
удаленный: удаленные удаленной удаленных
перестать: перестала
приток: притоком
камальадван: камальадван
альсахаба: альсахаба
осудить: осудил
танк: танк
цахал: цахал
меркава: меркава
сторожевой: сторожевой
вышка: вышке
кфаркила: кфаркила
камера: камеры
повидимому: повидимому
преднамеренный: преднамеренный
имущество: имущества
сириец: сирийцы
массово: массово
беннет: беннет
позитивный: позитивный позитивному
мэрилин: мэрилин
тридцать: тридцати
родственница: родственница
отчаяние: отчаяния
переживать: переживающие переживают переживаем
двоюродный: двоюродная двоюродные
сестра: сестра сестры
вступить: вступишь
закончиться: закончится
твой: твои
замедлиться: замедлятся
поменяться: поменяется
поделиться: поделилась поделиться
дестигматизации: дестигматизации
почувствовать: почувствовала
собеседница: собеседница
энергичный: энергичной
желание: желание
творить: творить
естественный: естественный естественную естественным
наложить: наложено
табу: табу
окутать: окутана
тайный: тайной
пролить: пролить
света: свет
подпитывать: подпитывают
непонимание: непонимание
болезненный: болезненно
переходный: переходный
прилив: приливы прилив
ночной: ночная
потливость: потливость
бывать: бывает
трансгендерные: трансгендерные
гендерно: гендерно
постменопаузе: постменопаузе
ценность: ценности ценность
терять: теряют теряет теряем
корениться: коренится
женоненавистничество: женоненавистничестве
действительность: действительности
постменопаузальные: постменопаузальные
ценный: ценны
способный: способны способно способен способную
вносить: вносить вносит вносят
эффект: эффектов эффекты эффектами эффект
социокультурный: социокультурные
раса: раса
этнический: этническая
класс: класс классов
менопаузального: менопаузального
пременопаузе: пременопаузе
различье: различий
переживаться: переживается
менопаузальный: менопаузальный
переоценка: переоценки
жизненный: жизненных жизненном жизненные
праздноваться: празднуется
ритуал: ритуала
плодородие: плодородия
церемония: церемониях церемонии
празднование: празднование
сигнализировать: сигнализировать
забота: заботы
уверенность: уверенности уверенность уверенностью
деторождение: деторождение
предназначение: предназначение
цениться: цениться
заслуживать: заслуживающими заслуживают
обратить: обратить
вспять: вспять
побочный: побочные побочными
смягчить: смягчить
облегчение: облегчение
контрацепция: контрацепции контрацепция контрацепцию
знаменоваться: знаменуется
самостоятельно: самостоятельно
обновление: обновления
перенаправить: перенаправить
личностный: личностного
увлечение: увлечений
карьерный: карьерных
цикля: цикле
андропауза: андропауза
термин: термин
обозначение: обозначения
влечение: влечения
эректильную: эректильную
дисфункция: дисфункцию
предполагать: предполагает предполагаемых предполагаемые
падение: падения падению
тестостерон: тестостерона тестостероном
эстроген: эстрогена
действительно: действительно
упражнение: упражнения
сбалансированный: сбалансированное
передний: переднем
край: крае края
молчание: молчание
голос: голоса голосом голос
преквалификацию: преквалификацию
биоаналог: биоаналог
списывать: списывать
счеты: счетов
возс: возс
пабст: пабст
мутировать: мутируют мутирует мутировал
неправильный: неправильное неправильного
чрезмерный: чрезмерное чрезмерного чрезмерным
замедлять: замедляют
недостаточный: недостаточных недостаточным недостаточного
предстоять: предстоит
вывести: вывести
менингит: менингита
брюшной: брюшного
тиф: тифа
перелом: перелома
сэкономить: сэкономить
бактериальный: бактериальной
теракт: теракта теракты
машив: машив
харуах: харуах
формат: формате
ретрита: ретрита
комфортный: комфортной
осмысливать: осмысливать
пережитое: пережитое пережитом
страшный: страшное
террористический: террористическое террористическими
ваш: вашему вашем
водитель: водители
непосредственно: непосредственно
ужасный: ужасных
впечатление: впечатление впечатления
увидеть: увиденное увидеть увидела увидели
опознавать: опознавать
тело: тела тело теле
погребение: погребению
дух: духа дух
психиатрический: психиатрическую психиатрической
вырабатывать: вырабатывать
формировать: формировать
эяль: эяль
кравиц: кравиц
просматривать: просматривал
видео: видео
невообразимый: невообразимо
както: както
иначе: иначе
соучредитель: соучредителем соучредитель
даниэль: даниэлем даниэль
шермоном: шермоном
шермон: шермон
веред: веред
ацмон: ацмон
мешулам: мешулам
записаться: записалась
горе: горем
общаться: общалась
поисковоспасательных: поисковоспасательных
сказаться: сказалось сказалась
психика: психике
бессонница: бессонница
посттравматический: посттравматическое
стрессовый: стрессовое
хаос: хаосе
найтись: нашлось
восполнить: восполнила
пустыня: пустыне
шум: шума
суета: суеты
групповой: групповых
взаимный: взаимной
кажется: кажется
понять: понять поняли поймете
солдат: солдат
моше: моше
сорока: сороки
привозить: привозили
рана: раны ранах
казаться: казалось
довестись: довелось
кемто: кемто
убедить: убедить
приехать: приехать приехали приехавших
ретритов: ретритов
переживание: переживаниями переживаниях
таль: таль
поисковоспасательной: поисковоспасательной
негосударственный: негосударственной
извлекать: извлекать
фестиваль: фестивале фестивали
выражать: выражать выражают
ретрите: ретрите
говорят: говорят
никуда: никуда
ктото: ктото
разговор: разговор разговоры
весь: вся
атмосфера: атмосферу
осмыслить: осмыслить
травматический: травматический
терапевт: терапевты
придать: придать
чтото: чтото
выкинуть: выкинуть
немного: немного
писать: писала
муж: муж мужа
ночь: ночь ночью
спать: спал
ретриты: ретриты
участница: участниц
ходайя: ходайя
леший: лешем
четверо: четверых
военнослужащий: военнослужащего
держаться: держалась
поступить: поступили поступило
шварцфукс: шварцфукс
глубина: глубине
сплотить: сплотило
рассказ: рассказы
приходить: приходили приходит
айелет: айелет
кибуцном: кибуцном
кибуцев: кибуцев
эвакуироваться: эвакуироваться
наружу: наружу
ощутить: ощутила
комфортно: комфортно
я: мной
выслушать: выслушать
сюда: сюда
ради: ради
посланник: посланниками
сначала: сначала
наедине: наедине
воспоминание: воспоминаниями
захотеть: захотят
психологически: психологически
замкнуть: замкнуть
круг: круг кругов
охотный: охотнее
вначале: вначале
замыкаться: замыкаетесь
гордиться: гордимся
поистине: поистине
бесценный: бесценно бесценна
признательность: признательность
нго: нго
мозаика: мозаика
религиозный: религиозных
еврейский: еврейских
мусульманский: мусульманских
психологопсихиатрическую: психологопсихиатрическую
приемлемый: приемлемыми
свести: свести
обращение: обращением обращению обращении
мом: мом
горячий: горячую
трансформировать: трансформировать
юнисефмджонсон: юнисефмджонсон
критерий: критериям критерий
медикосанитарными: медикосанитарными
правило: правилами
ммсп: ммсп
географический: географическим географическая географического
возч: возч
тефавал: тефавал
восьмой: восьмого восьмой
гутерриша: гутерриша
встречаться: встречаются
суицид: суицид
молча: молча
внимательный: внимательному
шестьдесят: шестьдесят
должностной: должностные должностными
нечто: нечто
осмысленность: осмысленность
общность: общности
угнетать: угнетающая
хаотичный: хаотичная
пагубный: пагубно
наступить: наступила
размываться: размываются
непростой: непростой
работодатель: работодатели
моральный: моральный
вовлеченность: вовлеченность
производительность: производительность производительности
пристальный: пристальное
предосторожность: предосторожности
возх: возх
мостафа: мостафа
привиться: привиться
войти: вошел войдут
наряд: наряду
старт: старт
девиз: девизом
подавлять: подавляющее
кипр: кипра
занизить: занижены
осеннезимнего: осеннезимнего
активизироваться: активизировалась активизируется
позаботиться: позаботиться
рекомендоваться: рекомендуется
втретьих: втретьих
вчетвертых: вчетвертых
чистота: чистоту
впятых: впятых
людный: людных
концепция: концепция концепцию
осознать: осознанный осознав осознала
лозунг: лозунгом
кристиан: кристиана
салви: салви
взаимодействие: взаимодействию взаимодействия взаимодействии
инфодемии: инфодемии
стимулировать: стимулирует стимулировать стимулируя
упреждающий: упреждающие
поощрять: поощряет
адресовать: адресованных
подгруппа: подгруппам
тезис: тезисов
хэштег: хэштег
информированный: информированные
обсерватория: обсерватория обсерватории
реабилитационный: реабилитационной реабилитационных
реабилитация: реабилитации реабилитация
аццопардимускат: аццопардимускат
страховой: страховое
покрытие: покрытие
поставщик: поставщиков
федерация: федерации
преобразовательный: преобразовательные
сравнительный: сравнительное
нетрудоспособность: нетрудоспособности
эвоут: эвоут
гиннекен: гиннекен
берлинский: берлинском
технологический: технологическом
учитываться: учитываться
оптимизация: оптимизацию
убийство: убийстве убийством
энергодар: энергодаре
возг: возг
ндебо: ндебо
подтверждение: подтверждении
тестовый: тестовый
ожидаться: ожидается
протестировать: протестировано
датский: датской
одобрение: одобрение
обостряться: обостряется
нгвакум: нгвакум
усилиться: усилились
европеец: европейцев
алкоголь: алкоголю алкоголя алкоголь алкоголем
возсволков: возсволков
толстый: толстой
кишка: кишки
спиртное: спиртными спиртных
переосмыслить: переосмыслить
задуматься: задуматься
праздник: праздниках
годный: годен
дорожный: дорожному
травматизм: травматизму
пить: пьющие пить
поведение: поведении поведения поведение
привычка: привычки
осуществить: осуществить
восприниматься: воспринимается воспринимались
регулироваться: регулируется
восприятие: восприятием восприятие
увы: увы
рекламироваться: рекламируется
сторонник: сторонниками
формирование: формированию формированиями
диагностировать: диагностировать диагностированных диагностирован диагностировали диагностировано
сердце: сердца сердце
разновидность: разновидность
стиль: стилем
тереть: трем
импульс: импульс
сглаживание: сглаживанию
проложить: проложить
сорин: сорин
съехаться: съехались
общеполитический: общеполитические
дебаты: дебаты дебатов
постепенный: постепенной
утрата: утраты утрате
восприимчивость: восприимчивости
наткнуться: наткнулся
пенициллин: пенициллин
лондонский: лондонской
лаборатория: лаборатории лабораторий
превратить: превратив
некогда: некогда
сдерживать: сдерживать
звучать: звучит
профинансировать: профинансировать
диверсификация: диверсификации
вкладчик: вкладчиков
многопартнерский: многопартнерский
трастовый: трастовый
подбираться: подбираться подбирается
меньшой: меньшим
возникновение: возникновения
соответственно: соответственно
жизнестойкий: жизнестойких
инклюзивных: инклюзивных
неуклонно: неуклонно
цюй: цюй
дунъюй: дунъюй
вода: водой
появляться: появляется
возбудитель: возбудителей возбудители
ингер: ингер
андерсен: андерсен
координационный: координационного
невооруженный: невооруженным
состояться: состоится
противогрибковый: противогрибковые
противопаразитарный: противопаразитарные
продолжительность: продолжительность продолжительности
утрачивать: утрачивают
возкматтингли: возкматтингли
незначительный: незначительная
рутинный: рутинная
обычный: обычная обычных
неожиданно: неожиданно
перерасти: перерасти
равносильный: равносильны
смертный: смертному
приговор: приговору
ускорять: ускоряют
незавершенный: незавершенные
фаол: фаол
тато: тато
неадекватный: неадекватные
санитарногигиенические: санитарногигиенические
сельхоз: сельхоз
микроорганизм: микроорганизмов микроорганизмах
путешествие: путешествия
урон: урон
удлинение: удлинением
возэивонн: возэивонн
невосприимчивый: невосприимчивых
выработаться: выработались
тотальный: тотальной
излечиваться: излечивающихся
рискованный: рискованными
хирургический: хирургические
кесарев: кесарево
сечение: сечение
эндопротезирование: эндопротезирование
тазобедренный: тазобедренного
сустав: сустава
химиотерапия: химиотерапия
ответственный: ответственному ответственный
возспабст: возспабст
многосекторального: многосекторального
отчетность: отчетность
катетер: катетера катетеров
периферический: периферическую
артерия: артерию
кровоток: кровотока
внутрисосудистый: внутрисосудистых
интернациональный: интернациональная
никарагуа: никарагуа
гватемала: гватемале гватемалы гватемала
естуконог: естуконог
викторий: виктория
валиков: валикова
сооснователь: сооснователь
приезжать: приезжают
высокопоставленный: высокопоставленные
чиновник: чиновники
некоммерческий: некоммерческих
нко: нко
стуконог: стуконог
корнеев: корнеева
доброволец: добровольцы
евгения: евгении
клещевой: клещевой
искренне: искренне
одинаковый: одинаковую
напрямую: напрямую
онлайн: онлайн
форум: форум
познакомиться: познакомиться познакомился
интересный: интересна
крепкий: крепкие
интересовать: интересует
корпоративный: корпоративное
превосходить: превосходят
какието: какието
параллельный: параллельные
заметить: заметили
нетворкинга: нетворкинга
фокусный: фокусных
рассчитывать: рассчитываем рассчитывать
какуюлибо: какуюлибо
просвещать: просвещаем просвещает просвещать
строительство: строительства
спасибо: спасибо
безусловно: безусловно
посвоему: посвоему
подавать: подавали
заявка: заявку
интерактивный: интерактивных
обсуждаться: обсуждаются
таки: таки
смотреть: смотреть
распределять: распределяя
неправительственный: неправительственных
делегат: делегатами
посодействовать: посодействует
приятный: приятным
деревенька: деревеньке
чуинахтахуюп: чуинахтахуюп
гористый: гористой
потомок: потомки
индеец: индейцев
майя: майя
буквальный: буквально
джунгли: джунглях
скажем: скажем
сальвия: сальвия
залив: залива
фонсека: фонсека
электричество: электричества электричество
питьевой: питьевой питьевую
какойто: какойто
завтрашний: завтрашнем
разтаки: разтаки
принцип: принципе принцип принципах
неравнодушный: неравнодушных
благотворитель: благотворителей
антарктида: антарктиды
максимально: максимально
плюс: плюс плюсах
далее: далее
рождаемость: рождаемости
какихто: какихто
наверное: наверное
виноватый: виноватых
добровольный: добровольных добровольное
стоять: стоять
суть: сути
замечательный: замечательную
нагорнокарабахского: нагорнокарабахского
экоактивистка: экоактивистка
цвет: цвета
клетка: клетки
синий: синяя
учитель: учителям учителя
санитарногигиенических: санитарногигиенических
распознавание: распознаванию
заблуждаться: заблуждаться
обновлять: обновляем
клеймо: клеймо
позор: позора позором
враждебность: враждебностью
ассоциироваться: ассоциируется
секс: сексом секса сексе секс сексу
клеймить: клеймят
заражаться: заражаются заражались
бытовой: бытовых
прикосновение: прикосновений
разительный: разительном
контраст: контрасте
панамериканский: панамериканской
здравоохранениядж: здравоохранениядж
демпстер: демпстер
стагнация: стагнация
шестая: шестой
низ: низ
откат: откат
разница: разница
пятилетнего: пятилетнего
асфиксия: асфиксия
врожденный: врожденные
аномалия: аномалии
неонатальный: неонатальный
сепсис: сепсис
кибербуллингу: кибербуллингу
самоубийство: самоубийство
десятый: десятый десятое
соль: соли
жир: жира
онлайнмире: онлайнмире
ирония: иронии
когдалибо: когдалибо
лишний: лишним
интересно: интересно
теплеть: теплеет
жара: жарой
деменция: деменция
альцгеймера: альцгеймера
деменции: деменции
деменцией: деменцией
удвоиться: удвоится
пьянство: пьянством
возгндебо: возгндебо
сдержать: сдержать
интервал: интервалом
гави: гави
одобренье: одобрений
восхищаться: восхищаемся
глубоко: глубоко
признательный: признательны
договоренность: договоренности
приостанавливаться: приостанавливались приостанавливаться
скорбеть: скорбят
эльфара: эльфара
суфьян: суфьян
джабер: джабер
абед: абед
джавад: джавад
крыша: крыше
снайпер: снайпером
пятеро: пятеро
берег: берега
тулькарм: тулькарм
нуршамс: нуршамс
электроснабжение: электроснабжения
соображение: соображений
самодельный: самодельных
взрывной: взрывных
роланда: роланд
фридрих: фридрих
инвалидный: инвалидных инвалидные инвалидная
коляска: колясок коляски коляска
спецкоординатор: спецкоординатор
видно: видно
разрушенье: разрушений
энергетический: энергетической
укгввандриевская: укгввандриевская
приближаться: приближается
зима: зиме зимы зиму
отключение: отключения
электроэнергия: электроэнергии
хранение: хранения
бесперебойный: бесперебойной
пищевой: пищевые
злоупотребление: злоупотребления
заживать: заживают
генератор: генераторов генератору генераторы
лекарственноустойчивыми: лекарственноустойчивыми
сборная: сборную сборных
модульный: модульную модульных модульные модульная модульное
одесский: одесской одесскую
планироваться: планируется
блоковый: блоков
германий: германии
своевременность: своевременность
днепропетровский: днепропетровскую
донецкий: донецкую
харьковский: харьковскую харьковской
сумский: сумскую сумской
безвозмездный: безвозмездно
реалия: реалии
материальный: материальную
предварительно: предварительно
изготовить: изготовленных
сель: селе
чегодаровка: чегодаровка
прифронтовой: прифронтовых
возведение: возведение
оснастить: оснащено
водопровод: водопровод
канализация: канализацию
встроить: встроенному
круглый: круглый
зимой: зимой
подача: подаче
заполнить: заполнить
непрерывный: непрерывная
чегодаровке: чегодаровке
черниговский: черниговской
херсонский: херсонской
николаевский: николаевской
постройка: постройки
заменять: заменяют
забросить: заброшенные
амбулаторный: амбулаторные
интегрироваться: интегрируются
неотъемлемый: неотъемлемой
кассетный: кассетных
боеприпас: боеприпасов
переместиться: переместиться переместились переместится
посетить: посетили посетить посетил
ханюнисе: ханюнисе
рафахе: рафахе
совокупный: совокупный
обходить: обходить
продлиться: продлиться продлится
въезд: въезд
спровоцировать: спровоцированной
въезжать: въезжать
освещать: освещают освещать
филипп: филипп
лаззарини: лаззарини
свободно: свободно
восхищение: восхищение
мужественно: мужественно
столкновение: столкновениях
дженине: дженине
тулькарме: тулькарме
двое: двое
тора: тор
веннесланд: веннесланд
несовершеннолетний: несовершеннолетних
потрясный: потрясен
написать: написал
страничка: страничке
столько: стольких
часом: часом
прошедший: прошедшая прошедшей прошедшие прошедший
семеро: семеро
неприемлемый: неприемлемо
настаивать: настаивают
ухудшаться: ухудшается
окрасить: окрашенные
палец: пальцы
кульминация: кульминацией
рика: рик
пиперкорн: пиперкорн
альмагази: альмагази
альбурейдж: альбурейдж
альмуссадер: альмуссадер
лазарини: лазарини
страница: странице
корреспондент: корреспонденты
освещение: освещения
въехать: въехать
редкий: редкой
полоса: полосой
адель: адель
ходр: ходр
соблюсти: соблюдены
вступительный: вступительном
описание: описанию описания
ютиться: ютятся
квадратный: квадратных
километр: километров
договориться: договориться
отступить: отступить
пропасти: пропасти
продолжиться: продолжилась
серия: серии серия
рсорин: рсорин
препаратм: препаратм
временно: временно
сохранение: сохранению
никак: никак
обусловить: обусловлена
некорректный: некорректным
свидетельство: свидетельств
утилизировать: утилизировать
неиспользованный: неиспользованные
годность: годности
истечь: истек
закончить: закончен закончил
рассмотрение: рассмотрения
муниципальный: муниципальных
производственный: производственных
площадка: площадок
академический: академических
закупщик: закупщиков
инспектор: инспекторов
введния: введния
нейра: нейра
покупатель: покупателям
инвестор: инвесторам
вакцианции: вакцианции
воскресенье: воскресенья воскресенье
антисанитарный: антисанитарные антисанитарных
месячный: месячного месячный
прессконференции: прессконференции
сэм: сэм
роуз: роуз
гонка: гонка гонкой
комментировать: комментируя
анализироваться: анализироваться
продлить: продлена
отреагировать: отреагировал отреагируем отреагировать
удерживаться: удерживавшихся
херш: херш
гольдбергполин: гольдбергполин
родственник: родственниками
советь: совей
безоговорочный: безоговорочного
юнфпаяфигула: юнфпаяфигула
познакомить: познакомить
сексуальность: сексуальности сексуальностью сексуальность
учить: учит учили
распознавать: распознавать
противостоять: противостоять
сверстник: сверстников сверстники
согласие: согласия
обученный: обученные
опытный: опытные
адаптировать: адаптировано
непредвзятый: непредвзятую
порнография: порнографии
ненадежный: ненадежным
онлайнисточникам: онлайнисточникам
всесторонний: всестороннее всестороннему всестороннего
политизировать: политизируют
консенсус: консенсус
серьезнейший: серьезнейших
предприниматься: предпринимается предпринимаются
посеять: посеять
риторика: риторика
противник: противников
развеять: развеянных развеять
предрасположенный: предрасположены
правда: правда
хищничество: хищничество
груминг: груминг
доверительный: доверительных
завоевание: завоевания
совращение: совращения
примред: примред
вмешиваться: вмешиваться
рабаа: рабаа
гесми: гесми
сусе: сусе
тунис: тунис
зандил: зандил
симелане: симелане
дурбан: дурбане
полезно: полезно
перевернуться: перевернулась
шокировать: шокировала
учиться: училась
посягательство: посягательств
хищнический: хищнически
настроить: настроенных настрой
точно: точно
откуда: откуда
благословлять: благословляющего благословляющий благословляет
деньга: деньгами
подарок: подарками
молодежный: молодежных
юнфпадабси: юнфпадабси
воздержание: воздержание воздержанию воздержания
отрицательный: отрицательные
задокументированы: задокументированы
прививать: прививают
контрацептив: контрацептивы
внебрачный: внебрачной
тири: тири
янгоны: янгоны
забеременеть: забеременела забеременев забеременеть
парень: парнем
влюбить: влюблены
опустошить: опустошена
учеба: учебу
оформить: оформили
брак: брак
переехать: переехала
родить: родила
уехать: уехал
распасться: распался
повезти: повезло
домыть: домой
вещь: вещам вещами
гделибо: гделибо
заводить: заводить
линь: линь
хоанг: хоанг
религия: религии
преподаваться: преподается
бутан: бутане
монах: монахами монахов
мышление: мышлении
лопен: лопен
шераб: шераб
дорджи: дорджи
монашеский: монашеского
корпус: корпуса
монахиня: монахини
бихар: бихар
традиционный: традиционные
исламский: исламские
джамия: джамия
миллия: миллия
исламия: исламия
ньюдели: ньюдели
урду: урду
мауланы: мауланы
азад: азад
хайдарабад: хайдарабаде
дивия: дивия
сания: сания
пропагандировать: пропагандирует
лгбткиа: лгбткиа
учащийся: учащихся
кьял: кьял
син: син
хтет: хтет
мона: мон
идентичность: идентичность
макияж: макияжем
реакция: реакция
издевательство: издевательств
решимость: решимость
сексуализирует: сексуализирует
невинность: невинности
цыганский: цыганская цыганского цыганской
создаваемый: создаваемых
сахин: сахин
рэдица: рэдица
цыган: цыган
посещаемость: посещаемости
знакомить: знакомит
неподобающий: неподобающим
прислушиваться: прислушиваться
недостоверный: недостоверной
ангола: анголе
проводник: проводниками
сильвий: сильвия
франциско: франциско
луанда: луанда
укорениться: укоренившиеся
отсрочка: отсрочки
сенегал: сенегале
хади: хади
посещение: посещения
мастурбация: мастурбацию
обучаться: обучаются
деликатный: деликатные
поднимать: поднимаемые
дидактичекую: дидактичекую
легализовать: легализует
педофилия: педофилию
декриминализация: декриминализации
отмена: отмене отмена
тигист: тигист
изнасиловать: изнасилована
горничная: горничной
уволить: уволили уволены
заняться: занялась заняться
проституция: проституцией
замбия: замбии замбия
присущий: присуща
длиться: длится длиться
беременеть: беременели
лидий: лидия
ученица: ученица
лусака: лусаке
одноклассник: одноклассники
юнеско: юнеско
вропейского: вропейского
жестокость: жестокости
заморозка: заморозка
вичспидом: вичспидом
юнисефкшермбрукер: юнисефкшермбрукер
остановка: остановке
исключительный: исключительные
закрытый: закрыты закрытыми
арт: арт
правительственный: правительственные
усугубиться: усугубиться
лгбтсообщество: лгбтсообщество
котдивуаре: котдивуаре
покрывать: покрывая покрывает
послабление: послаблений
мозамбик: мозамбике мозамбик мозамбика
кения: кении
гана: гане
лубрикантов: лубрикантов
экспресстестов: экспресстестов
антиретровирусных: антиретровирусных
дополнительно: дополнительно
доконтактная: доконтактная
гаити: гаити
танзания: танзания танзании
финансироваться: финансируется
двухэтапная: двухэтапная
видеосвязи: видеосвязи
пожизненный: пожизненный
идеальный: идеальная
беспрепятственный: беспрепятственный
густонаселенный: густонаселенных
тулькареме: тулькареме
иерусалим: иерусалиме
оонзталеб: оонзталеб
промежуток: промежутком
прессбрифинге: прессбрифинге
длительность: длительность
объявляться: объявляться
восемьдевять: восемьдевять
продлеваться: продлеваться
готовиться: готовятся
тяжелобольной: тяжелобольных
оонд: оонд
дикинсон: дикинсон
противозачаточный: противозачаточные противозачаточных
незапланированный: незапланированной незапланированных
обнародовать: обнародованы
многоэтапный: многоэтапного
опросить: опрошено
незащищенный: незащищенного незащищенные
вступать: вступают вступающих вступающими
нежелательный: нежелательную
небезопасный: небезопасные небезопасна
аборт: аборты
просвещение: просвещение
удивление: удивления
доступно: доступно
предпосылка: предпосылки
дра: дра
пожинать: пожинает
горький: горькие
реакционный: реакционных
впереди: впереди
малообеспеченный: малообеспеченных
подавленность: подавленность
погода: погода
акушерка: акушерке акушеркам акушерка
жар: жара жару жаре
частота: частоты
николетта: николетт
митала: митала
орсолия: орсолия
хейм: хейм
ника: ники
орси: орси
будапешт: будапеште
венгрия: венгрия венгрии венгрию
триместр: триместр
изнурять: изнуряющая
поразному: поразному
тошнота: тошноты
кузина: кузина кузинам
особенный: особенное
радость: радостью
будапештский: будапештских
парок: парков
отдых: отдыха
тень: тени
градус: градусов градуса
цельсий: цельсия цельсию
подниматься: поднималась
влажность: влажности
бутылка: бутылку
веер: веер
отличие: отличие
развиться: развилась развился
гипертония: гипертония
отечность: отечность
обручальный: обручальное
кольцо: кольцо
туфля: туфли
сандалия: сандалии
носовой: носовые
сохранять: сохраняет сохранять
волноваться: волнуюсь
участковый: участковой участков
обследование: обследованиям
дочь: дочерью
посоветовать: посоветовали
физически: физически
физиотерапевт: физиотерапевтом
кондиционер: кондиционеры
обрушиваться: обрушивается
замешательство: замешательство
приближение: приближения
предпочитать: предпочитают
дипломированный: дипломированная
гринсток: гринсток
великобритания: великобритании
таковой: таковую
перегреваться: перегревались
кондиционировать: кондиционированных
охладиться: охладиться
выпивать: выпивать выпивая
литр: литра
жидкость: жидкости жидкостями
носов: носовой
платок: платок
смочить: смочить
охлаждение: охлаждения охлаждение
вредно: вредно
нормально: нормально
подходить: подходит
прохладный: прохладном прохладный
разогнать: разогнать
зарядить: зарядить
охлаждаться: охлаждаться
прекрасный: прекрасный
солнцезащитный: солнцезащитным
крем: кремом
головной: головной головные
убор: убор
тенистый: тенистое
обгореть: обгореть
мелазмы: мелазмы
темный: темных
пятно: пятен
обесцветить: обесцвеченных
обернуться: обернулась
паралимпийский: паралимпийский
ассистивных: ассистивных
брути: брути
мпк: мпк
паралимпийских: паралимпийских
применять: применяемых
ассистивные: ассистивные
пропаганда: пропаганды
вспомогательный: вспомогательных вспомогательные
приспособление: приспособлений
паралимпийцами: паралимпийцами
беговой: беговые
протез: протезы
спусковой: спусковые
стрельба: стрельбы
лука: лука
поднять: поднять
планка: планку
паралимпийские: паралимпийские
ассистивным: ассистивным
ввиду: ввиду
предложение: предложения
уделить: уделить
немногие: немногих
состязание: состязания
наглядный: наглядной
атлет: атлеты
спортивный: спортивных спортивные
председатель: председатель
эндрю: эндрю
парсонс: парсонс
вдохновить: вдохновить
удовлетворить: удовлетворен
отчуждение: отчуждения
зимбабве: зимбабве
привлекать: привлекая
побуждать: побуждать
включение: включению
недорогой: недорогим
косвенно: косвенно
зритель: зрителей
лидировать: лидируют
юнисефджбенекире: юнисефджбенекире
потребоваться: потребуется
изложить: изложенных
всеобъемлющий: всеобъемлющую
увкб: увкб
руанда: руанде руанды
граничить: граничащих
кладой: кладой
подозреваться: подозреваются
отрезать: отрезаны
ночевать: ночуют
небо: небом
выздоровление: выздоровления
усиливать: усиливают усиливает
десятимесячного: десятимесячного
дейрэльбалахе: дейрэльбалахе
левый: левой
геномного: геномного
секвенирования: секвенирования
июнь: июне июня
передвижной: передвижных
переезжать: переезжать
издать: издали
сняться: сняться
муханнад: муханнад
противоположный: противоположному
селиться: селиться
переселить: переселенной
элементарный: элементарными
удобство: удобствами
юар: юар
одновременный: одновременного
эфиопиим: эфиопиим
айен: айен
рог: роге рога
эми: эми
поуп: поуп
миграционный: миграционный
хаб: хаб
эсватини: эсватини
малави: малави
клад: клада клады кладе
оговориться: оговорилась
постельный: постельное
белье: белье
сыпать: сыпь
язва: язв
мышечный: мышечные
горло: горле
лимфатический: лимфатических
узел: узлов
маира: маир
подразделение: подразделения
минута: минуту
джоанн: джоанн
ким: ким
зеландия: зеландии
меланезии: меланезии
полинезии: полинезии
выживать: выживают
изабель: изабель
сурджоматарам: сурджоматарам
разрыв: разрыва
проявить: проявив
однозначно: однозначно
ответить: ответил
недискриминационный: недискриминационные
окончательно: окончательно
ежемесячно: ежемесячно
швеция: швеция швеции
прима: прим
редакция: ред
серьезнойчем: серьезнойчем
усилить: усилить
ныне: ныне
копенгаген: копенгагене
производиться: производится
заказ: заказу
накопить: накоплены
щедрый: щедра
онаведет: онаведет
возк: возк
малиро: малиро
случать: случаемы
цикл: цикл
бъет: бъет
регистрировать: регистрировала
вооружение: вооружений
повреждение: повреждения повреждениями
уничтожаться: уничтожались
эмануэль: эмануэль
бруни: бруни
гибнуть: гибнут
повторный: повторных
вспомнить: вспомнил
одесса: одессе
сирена: сирены
печальный: печальная
разбить: разбила
фельдшер: фельдшеров
функциональный: функциональной
заполнение: заполнение
герой: герои
отдавать: отдаем
дань: дань
обещать: обещаем
неизбежность: неизбежностью
дданиэль: дданиэль
невыносимый: невыносимого
нагревание: нагревания
повышаться: повышается
наблюденье: наблюдений
жараубийца: жараубийца
теплов: тепловой тепловых
цереброваскулярные: цереброваскулярные
шоковый: шоков
подобныепланы: подобныепланы
убивать: убивает
защититься: защититься
оставлять: оставляйте
припарковать: припаркованных
какоето: какоето
охлаждать: охлаждаемых охлаждать
зайти: зайдите
супермаркет: супермаркет
прохлада: прохладу
тепловой: тепловую теплового
жалюзи: жалюзи
ставень: ставни
одежда: одежду
ванна: ванну
сладкое: сладких
алкогольный: алкогольных
кофеин: кофеином
тройной: тройной
шведский: шведских шведские
взаимосвязанность: взаимосвязанность
стандартный: стандартные
низка: низкой
бдительность: бдительность
стигматизировать: стигматизировать
дискриминировать: дискриминировать
осеннезимний: осеннезимний
голдсмит: голдсмит
регнери: регнери
микроскоп: микроскопом
медикосанитарных: медикосанитарных
семью: семью
весить: весь
матшидисо: матшидисо
моэти: моэти
эпидемиолог: эпидемиологов
антрополог: антропологов
трансграничный: трансграничного
наращиваться: наращиваются
реагент: реагентов
децентрализация: децентрализации
свойственный: свойственной
отнестись: отнестись
серьезность: серьезностью
типичный: типичными
кожный: кожная
слизистая: слизистых
оболочка: оболочек
двухчетырех: двухчетырех
сопровождаться: сопровождаться
мышца: мышцах
слабость: слабостью
матсидисо: матсидисо
моети: моети
прерывание: прерывание
фджонс: фджонс
отни: отни
океанический: океанических
атмосферный: атмосферных
неоднократно: неоднократно
селеста: селеста
сауло: сауло
долина: долине
калифорний: калифорнии
рекордный: рекордная рекордных
среднемесячный: среднемесячная
рекорд: рекорд рекордов
ледяной: ледяные
щит: щиты
первопричина: первопричину
парниковый: парниковых
балкан: балкан
отрицательно: отрицательно
греция: греции грецию
португалия: португалии
марокко: марокко
словения: словению
хорватия: хорватию
болгария: болгарию
июльский: июльских
фабра: фабра
температурный: температурных
ласвегас: ласвегас
сжечь: сожгли
гектар: гектаров
лес: леса
выгореть: выгоревшей
бушевать: бушевало
изпод: изпод
канадский: канадского
межведомственный: межведомственного
британский: британская британской
колумбия: колумбия колумбии
альберт: альберта
сгореть: сгорело
полмиллиарда: полмиллиарда
экстремально: экстремально
мали: мали
нигер: нигере
гестационные: гестационные
неблагоприятный: неблагоприятным
мертворождение: мертворождение
сухой: сухому
спастись: спастись
пероральной: пероральной
вакцинный: вакцинного вакцинный
вялый: вялый
холодов: холодовой
цепь: цепи
бой: боев
напряженность: напряженность
полиовакцины: полиовакцины
органиазция: органиазция
дисциплина: дисциплин
таков: таковы
ланцет: ланцет
чей: чью
дания: дания
исландия: исландия
королевство: королевство
нидерланды: нидерландов
мальта: мальта
абсолютный: абсолютное
конкуренция: конкуренцией
вполне: вполне
многолюдный: многолюдных
одноразовый: одноразовая
одышка: одышка
заражать: заражать
предсказать: предсказать
ориентироваться: ориентируясь
икао: икао
авиакомпания: авиакомпании