сокращение: сокращение сокращения
помощь: помощи помощь помощью
сша: сша
подорвать: подорвет
деятельность: деятельность деятельности
агентство: агентств
оон: оон
защита: защите
психический: психического психическое
здоровье: здоровья здоровье
украинец: украинцев украинцам
новость: новости
перейти: перейти
основное: основному основном
добро: добро
пожаловать: пожаловать
русский: русский
другой: другие
глобальный: глобальный
взгляд: взгляд
человеческий: человеческие
судьба: судьбы
поиск: поиск
расширить: расширенный
язык: язык
меню: меню
главный: главная
азия: азия
америка: америка
африка: африка
ближний: ближний
восток: восток
европа: европа
тема: темы теме
гуманитарный: гуманитарная гуманитарных гуманитарной
беженец: беженцы
мигрант: мигранты
женщина: женщины женщине женщин
здравоохранение: здравоохранение здравоохранения
климат: климат
окружать: окружающая
среда: среда
культура: культура
образование: образование
международный: международное
правый: право права прав
мир: мир мире
безопасность: безопасность безопасности
генеральный: генеральный генерального
секретарить: секретарь секретаря
человек: человека люди человек людям людей
цель: цели
устойчивый: устойчивого
развитие: развития развитие
экономический: экономическое экономических экономической
подробный: подробнее
интервью: интервью
сюжет: сюжеты
экспресс-новости: экспресс-новости
фоторепортаж: фоторепортажи
пресс-секретарь: пресс-секретарь
выступление: выступления
заявление: заявления
пресса: прессой
официальный: официальные
поездка: поездки
фотография: фотографии
пресс-релиз: пресс-релизы
группа: группа групп
аккредитация: аккредитации
сми: сми
интернет-трансляция: интернет-трансляция
аудиотека: аудиотека
подписаться: подписаться
мобильный: мобильные мобильной мобильная мобильных
бригада: бригады бригада бригад
психосоциальной: психосоциальной
поддержка: поддержки поддержке поддержка
юнфпа: юнфпа
оказывать: оказывают
население: населению населения
всеять: всей
украина: украине украины украина
число: числе число
линия: линии
фронт: фронта
печать: печать
марта: марта
связь: связи
прекращение: прекращением
финансовый: финансовой финансовые
фонд: фонда
область: области
народонаселение: народонаселения
пострадать: пострадают пострадало
тысяча: тысяч
жительница: жительниц
который: которые который которой которым
получать: получали
психосоциальную: психосоциальную
также: также
пользоваться: пользовались пользоваться
безопасный: безопасными безопасного
пространство: пространствами
программа: программами программ
расширение: расширения расширению
возможность: возможностей возможность возможности
молодая: молодая
мама: мама
пять: пятью
ребенок: детьми дети
выходить: выходит
поезд: поезда
город: городе
днепр: днепр днепре
держать: держа
рука: руках
небольшой: небольшую
сумка: сумку
спасаться: спасается
российский: российских
атака: атак атаками
запорожский: запорожской
жестокий: жестокого
партнер: партнера партнеров
однажды: однажды
избить: избил
сильный: сильно сильного
случиться: случился случившееся
выкидыш: выкидыш
нужный: нужна
медицинский: медицинская медицинское медицинские
юридический: юридическая юридической
искать: ищет
место: место месте
встретить: встретили
вокзал: вокзале
рассказывать: рассказывает
татьяна: татьяна
психолог: психолог
организовать: организовали
сопровождение: сопровождение
адвокат: адвокатов
помочь: помочь
документ: документами
война: война войны
домашний: домашнее домашнем
насилие: насилие насилии насилия насилием
работать: работает
год: года лет году годом
являться: является являемся
один: одной
создать: созданных создали
оказание: оказания оказание оказании
экстренный: экстренной
украинка: украинкам украинок
попасть: попавшим
беда: беду
специалист: специалисты специалистами
помогать: помогают помогать помогает
находить: находить
долгосрочный: долгосрочное долгосрочной долгосрочного
решение: решение
возникнуть: возникших
проблема: проблем проблемы
предоставлять: предоставляют
получить: получить полученным
профессиональный: профессиональную
подготовка: подготовку
устроиться: устроиться
работа: работу работы работа
доступ: доступ
пережить: пережившие пережившим
нуждаться: нуждаются нуждающихся
первоначальный: первоначальная первоначальной
опасность: опасность
миновать: миновала
особенно: особенно
страна: стране
травмировать: травмированы
результат: результате
три: трех
момент: момента момент
полномасштабный: полномасштабного
вторжение: вторжения
россия: россии
назад: назад
сообщение: сообщений
сторона: стороны
интимный: интимного
сексуальный: сексуальном сексуального сексуальное
вырасти: выросло
раз: раза
оценка: оценкам
миллион: миллиона
девочка: девочки девочек
остро: остро
услуга: услугах услуги услуг
предотвращение: предотвращению
гендерный: гендерного
реагирование: реагированию реагирования
обрести: обретя
некоторый: некоторую
физический: физическую
многие: многие многих
бороться: борются
затяжной: затяжными
панический: паническими
ночное: ночными
кошмар: кошмарами
симптом: симптомами
депрессия: депрессии депрессию
говорить: говорит
два: две
треть: трети
семья: семей семьи
сообщать: сообщают
ощущать: ощущают
тревога: тревогу
находиться: находятся
воздействие: воздействием воздействие
стресс: стресса стрессом
психологический: психологические психологической
мешать: мешают
найти: найти
заботиться: заботиться
член: членах
уход: уходе
трудность: трудности трудностями
массовый: массовая
потеря: потеря
смерть: смерть
близкие: близких
страх: страх
новый: новыми новом новым
усугублять: усугубляют
страдание: страдания
надлежащий: надлежащей
последствие: последствия
травма: травмы
мочь: могут могли
ощущаться: ощущаться
будущее: будущими
поколение: поколениями
это: это
означать: означает
широкомасштабный: широкомасштабное
общество: общество
выжить: выжить
первый: первый
шаг: шаг
роман: роман романа
присоединиться: присоединился
команда: команде
качество: качестве
социальный: социального социальными социальные
работник: работника работники работников
апрель: апреле
заниматься: занимается
обеспечение: обеспечением обеспечения
координация: координации
служба: службами службы
общественный: общественными
организация: организациями организация
система: систему
слово: словам
править: правило
реагировать: реагируют
случай: случаи случае
сразу: сразу
полиция: полиции полиция
свое: своего свои своих
род: рода
скорый: скорой
инцидент: инцидентов инцидента
добляет: добляет
жизненно: жизненно
важный: важны важна важную важной
иметь: имеющих имеют иметь
стабильный: стабильного
доход: дохода
жилье: жилья
поставить: поставила
угроза: угрозу угрозе угрозой
эксплуатация: эксплуатации
сделать: сделала
уязвимый: уязвимыми уязвимым
думать: думают
выживание: выживание
конец: конец
история: истории
отмечать: отмечает
настоящее: настоящее
исцеление: исцеление
начинаться: начинается
обеспечить: обеспечена
полный: полная
трудный: трудно
оправиться: оправиться
предотвратить: предотвратить
дальнейший: дальнейшие дальнейших
кризисный: кризисных
ситуация: ситуациях ситуацию
возрастать: возрастает
риск: риск риски
отношение: отношении
условие: условиях условия
конфликт: конфликта конфликт
резкий: резко
расти: растет
спрос: спрос
переместить: перемещенные
зачастую: зачастую
друг: друзей
родные: родных
обратиться: обратиться
прибегать: прибегает
действие: действий
такой: таких такого
консультация: консультации
медработник: медработники
обстрел: обстрелом
создавать: создает
сам: самих самом
прибывать: прибываем
временить: времени
раскачка: раскачку
объяснять: объясняет
включаться: включаемся
начинать: начинаем
просто: просто
задумываться: задумываться
чувствовать: чувствуем
поздний: позже
оглядываться: оглядываемся
обсуждать: обсуждаем
понимать: понимаем
какой: какими
мы: нам
прийтись: пришлось
столкнуться: столкнуться
дело: деле
февраль: февраля
всемирный: всемирная
подтвердить: подтвердила
нападение: нападений
учреждение: учреждения
медперсонал: медперсонал
территория: территории
прошлый: прошлом
медучреждение: медучреждений
ранее: ранее
признать: признает
критически: критически
выполнять: выполнять
нелегко: нелегко
каждый: каждым
становиться: становится
тяжелый: тяжелее
настраиваться: настраиваемся
эмоция: эмоции
стараться: стараемся
отложить: отложить
преодолеть: преодолен
острый: острый
кризис: кризиса
пытаться: пытаемся
справиться: справиться
потребность: потребность
правительство: правительство
финансировать: финансирует
психосоциальных: психосоциальных
проект: проект
сыграть: сыграл
незаменимый: незаменимую
роль: роль
наиболее: наиболее
слой: слоям
городской: городские
функционировать: функционируют
охват: охвата
почему: почему
необходимый: необходимы
время: время
приходиться: приходится
деть: дело
волна: волнами
переселение: переселений
обеспечивать: обеспечивают
жизнестойкость: жизнестойкость
играть: играют
рынок: рынке
труд: труда
самый: самым
негативный: негативным
образ: образом
сказываться: сказывается
благополучие: благополучии
решающий: решающее
значение: значение
восстановление: восстановления
неопределенность: неопределенности
финансирование: финансирования
перспектива: перспективы
все: всем
лишиться: лишиться
основной: основных
способствовать: способствующих
подписываться: подписывайтесь
наш: нашу наши
рассылка: рассылку
загружать: загружайте
приложение: приложение
устройство: устройств
европейский: европейское
бюро: бюро
воз: воз
расширять: расширяет
мера: меры
житель: жителей
роды: роды
контекст: контексте
ресурс: ресурсы
информация: информация
новостной: новостные
анонс: анонсы
журнал: журнал
отчет: отчеты
заседание: заседаниях
аудиовизуальный: аудиовизуальные
материал: материалы
общение: общение
твиттер: твиттер
последний: последние
главное: главные
брифинг: брифингов
стенограмма: стенограммы
комментарий: комментарии
журналист: журналистов
интернет: интернете
фейсбук: фейсбук
вконтакте: вконтакте
контакт: контакты
сайт: сайтом
указатель: указатель
часто: часто
задавать: задаваемые
вопрос: вопросы
остерегаться: остерегайтесь
мошенничество: мошенничества
конфиденциальность: конфиденциальность
пользование: пользования
пожертвование: пожертвования