газ: газа газы газе
охватить: охваченном охвачено
боев: боевыми
действие: действиями действия
север: севере
анклав: анклава
удаться: удалось
привить: привить
полиомиелит: полиомиелита полиомиелит полиомиелиту
тысяча: тысячи
ребенок: детей дети
новость: новости
оон: оон
перейти: перейти
основное: основному
добро: добро
пожаловать: пожаловать
русский: русский
другой: другие других
глобальный: глобальный
взгляд: взгляд
человеческий: человеческие
судьба: судьбы
поиск: поиск
расширить: расширенный
язык: язык
меню: меню
главный: главная
азия: азия
америка: америка
африка: африка
ближний: ближний
восток: восток
европа: европа
тема: темы теме
гуманитарный: гуманитарная гуманитарные гуманитарных
помощь: помощь
беженец: беженцы беженцев
мигрант: мигранты
женщина: женщины
здравоохранение: здравоохранение здравоохранения
климат: климат
окружать: окружающая
среда: среда
культура: культура
образование: образование
международный: международное
правый: право права
мир: мир
безопасность: безопасность безопасности
генеральный: генеральный генерального
секретарить: секретарь секретаря
человек: человека люди
цель: цели
устойчивый: устойчивого
развитие: развития развитие
экономический: экономическое
подробный: подробнее
интервью: интервью
сюжет: сюжеты
экспресс-новости: экспресс-новости
фоторепортаж: фоторепортажи
пресс-секретарь: пресс-секретарь
выступление: выступления
заявление: заявления заявлении
пресса: прессой
официальный: официальные
поездка: поездки
фотография: фотографии
пресс-релиз: пресс-релизы
группа: группа
аккредитация: аккредитации
сми: сми
интернет-трансляция: интернет-трансляция
аудиотека: аудиотека
подписаться: подписаться
воз: воз
северный: северной северном
частить: части
процент: процентов
полностью: полностью
вакцинировать: вакцинированы вакцинировать
печать: печать
ноябрь: ноября
несмотря: несмотря
продолжаться: продолжающиеся продолжающихся
боевой: боевые
завершиться: завершилась
кампания: кампания кампании кампанию
вакцинация: вакцинации вакцинация
активно: активно
поддерживать: поддерживаемая
агентство: агентствами агентстве агентств
осадить: осажденном
сектор: секторе сектора
понедельник: понедельник
второй: вторую второй
доза: дозу дозы
прививка: прививки
получить: получили получит
юный: юных
палестинец: палестинцев
находиться: находятся находится
досягаемость: досягаемости
медиков: медиков
значит: значит
защитить: защищены
опасный: опасного
вирус: вируса
слово: словам
ричард: ричарда
пиперкорна: пиперкорна
представитель: представителя
всемирный: всемирной
организация: организации
оккупировать: оккупированных
палестинский: палестинских палестинское
территория: территориях
задача: задача
проживать: проживающих
однако: однако
сделать: сделать
это: это
приказ: приказов
эвакуация: эвакуации
сторона: стороны
израиль: израиля израиль
вынудить: вынужденных
перемещение: перемещений
население: населения население
непрекращающийся: непрекращающихся
обстрел: обстрелов
ближневосточный: ближневосточном
дело: делам
бапор: бапор
заявить: заявили
настоящее: настоящее
время: время
пауза: паузы пауз
иметь: имеют
решающий: решающее
значение: значение
развертывание: развертывания
жизненно: жизненно
важный: важной
долгосрочный: долгосрочного
режим: режима
прекращение: прекращения
огонь: огня
быть: будут
далекий: дальше
страдать: страдать
умирать: умирать
говориться: говорится
сообщение: сообщении
опубликовать: опубликованном
социальный: социальных
сеть: сетях
рано: рано
утро: утром утра
сообщаться: сообщается
медицинский: медицинские
центр: центры центрах
приводить: приводили
подвергаться: подвергались
нападение: нападениям нападения нападений
глава: глава главу
тедрос: тедрос
адханом: адханом
гебрейесус: гебрейесус
минувший: минувшие
выходной: выходные
выразить: выразил
серьезный: серьезную
обеспокоенность: обеспокоенность
связь: связи
атака: атакой
один: одну одного
клиника: клиник
юнисеф: юнисеф
просить: просит
провести: провести
расследование: расследование
детский: детского
фонд: фонда
кэтрин: кэтрин
рассел: рассел
поздно: поздно
вечер: вечером вечера
суббота: субботу
подчеркнуть: подчеркнула
гражданский: гражданских
лицо: лиц
число: числе число
работник: работников
также: также
остаться: осталось
объект: объектов
инфраструктура: инфраструктуры
должен: должны
прекратиться: прекратиться
вместе: вместе
ужасать: ужасающим
уровень: уровнем
детская: детской
смертность: смертности
результат: результате результатов
последний: последние
событие: события
совокупность: совокупности
вписывать: вписывают
мрачный: мрачную
летопись: летопись
самый: самых
тяжелый: тяжелых
период: периодов
кошмарный: кошмарной
война: войны войной война
сказать: сказала
особенно: особенно
угроза: угрозой
смерть: смерти
болезный: болезней
голод: голода
бомбардировка: бомбардировок
предупредить: предупредила
добавить: добавив добавлены
немедленно: немедленно
расследовать: расследовать
обстоятельство: обстоятельства
сотрудник: сотрудника
принять: принять принял
мера: меры
привлечение: привлечения
ответственность: ответственности
виновный: виновных
добиваться: добиваться
условие: условиях условия
инцидент: инциденты
произойти: произошли
согласовать: согласованных
действовать: действовавших
течение: течение
трехдневной: трехдневной
искоренить: искорененный
год: лет года
назад: назад
напомнить: напомним
вновь: вновь
появиться: появился
начало: начале
фон: фоне
многочисленный: многочисленных многочисленным
кризис: кризисов
вызвать: вызванных
который: которая которого которых
начаться: началась
смертоносный: смертоносных
хамас: хамас
октябрь: октябре октября
сегодняшний: сегодняшний
деть: день
газа: газой
унести: унесла
жизнь: жизней
дать: данным
министерство: министерства министерство
привести: привела
разрушение: разрушениям
трудность: трудности
ограничить: ограниченный
доступ: доступ
технический: технический
комитет: комитет
состав: состав
входить: входят
палестина: палестины
партнер: партнеры партнеров
решение: решение
возобновить: возобновить
отложить: отложена
отсутствие: отсутствия
гарантия: гарантий
бригада: бригад
направить: направлены
стационарный: стационарных
пункт: пунктов
обеспечение: обеспечения
больший: большей
доступность: доступности
район: районах районе
бежать: бегут
спасаться: спасаясь
бомбежка: бомбежек
присоединиться: присоединились
повышать: повышать
осведомленность: осведомленность
миссия: миссия
выполнить: выполнена
последовать: последовала
успешный: успешным
осуществление: осуществлением
программа: программы
центральный: центральной
южный: южной
часть: частях
составлять: составляет
целевой: целевого
показатель: показателя
этот: этих
остановить: остановить
распространение: распространение
полиовируса: полиовируса
необходимо: необходимо
менее: менее
каждый: каждом
специалист: специалисты
отмечать: отмечают
задержка: задержка
введение: введением
снижать: снижает
эффективность: эффективность
значительный: значительное
вакцина: вакцину
болезнь: болезнь
проявиться: проявиться
соседний: соседних
страна: странах
подписываться: подписывайтесь
наш: нашу наши
рассылка: рассылку
загружать: загружайте
приложение: приложение
мобильный: мобильных
устройство: устройств
готовый: готово
генсек: генсек
объявить: объявил
подготовка: подготовке
масштабный: масштабной
возобновиться: возобновится
массовый: массовая
ресурс: ресурсы
информация: информация
новостной: новостные
анонс: анонсы
журнал: журнал
отчет: отчеты
заседание: заседаниях
аудиовизуальный: аудиовизуальные
материал: материалы
общение: общение
твиттер: твиттер
главное: главные
брифинг: брифингов
стенограмма: стенограммы
комментарий: комментарии
журналист: журналистов
интернет: интернете
фейсбук: фейсбук
вконтакте: вконтакте
контакт: контакты
пользоваться: пользоваться
сайт: сайтом
указатель: указатель
часто: часто
задавать: задаваемые
вопрос: вопросы
остерегаться: остерегайтесь
мошенничество: мошенничества
конфиденциальность: конфиденциальность
пользование: пользования
пожертвование: пожертвования