воз: воз
международный: международный международное
паралимпийский: паралимпийский
комитет: комитет
объединить: объединили
усилие: усилия
привлечь: привлечь
внимание: внимание внимания
важность: важности
ассистивных: ассистивных
технология: технологий технологии технологиям технологиях
новость: новости
оон: оон
перейти: перейти
основное: основному
добро: добро
пожаловать: пожаловать
русский: русский
другой: другие
глобальный: глобальный глобальных глобального
взгляд: взгляд
человеческий: человеческие
судьба: судьбы
поиск: поиск
расширить: расширенный
язык: язык
меню: меню
главный: главная главную
азия: азия
америка: америка
африка: африка
ближний: ближний
восток: восток
европа: европа
тема: темы теме
гуманитарный: гуманитарная
помощь: помощь помощи помощью
беженец: беженцы
мигрант: мигранты
женщина: женщины
здравоохранение: здравоохранение здравоохранения
климат: климат
окружать: окружающая
среда: среда
культура: культура
образование: образование
правый: право права
мир: мир мире миру
безопасность: безопасность
генеральный: генеральный генерального
секретарить: секретарь секретаря
человек: человека человек люди людей людям
цель: цели целях
устойчивый: устойчивого
развитие: развития развитие развитию
экономический: экономическое экономическому экономический
подробный: подробнее
интервью: интервью
сюжет: сюжеты
экспресс-новости: экспресс-новости
фоторепортаж: фоторепортажи
пресс-секретарь: пресс-секретарь
выступление: выступления
заявление: заявления
пресса: прессой
официальный: официальные
поездка: поездки
фотография: фотографии
пресс-релиз: пресс-релизы
группа: группа
аккредитация: аккредитации
сми: сми
интернет-трансляция: интернет-трансляция
аудиотека: аудиотека
подписаться: подписаться
брути: брути
мпк: мпк
быть: будут
использовать: использовать используемых используют
платформа: платформу
паралимпийских: паралимпийских
игра: игр игры играх
распространение: распространения
сообщение: сообщений
информация: информации информация
печать: печать
август: августа
время: время
париж: париже
всемирный: всемирная
организация: организация
огромный: огромному огромную
потенциал: потенциалу
применять: применяемых
область: области
спорт: спорта спорте
кампания: кампания кампании
оборудование: оборудование
равный: равных
возможность: возможностей возможностями возможность
призвать: призвана
продемонстрировать: продемонстрировать продемонстрированы
роль: роль
который: которую которые которым
ассистивные: ассистивные
играть: играют
жизнь: жизни жизнь
спортсмен: спортсменов спортсменами
пропаганда: пропаганды
согласовать: согласованных
действие: действий
расширение: расширению расширение
доступ: доступа доступ
использоваться: используются
почему: почему
всеобщий: всеобщий всеобщему всеобщего
иметь: имеет имеют
столь: столь
большой: большое
значение: значение
пример: примерам примеры
вспомогательный: вспомогательных вспомогательные
приспособление: приспособлений
паралимпийцами: паралимпийцами
относиться: относятся
беговой: беговые
протез: протезы
инвалидный: инвалидные инвалидная
коляска: коляски коляска
спусковой: спусковые
устройство: устройства устройств
стрельба: стрельбы
лука: лука
рамка: рамках
также: также
представить: представлены
личной: личные
история: истории
повседневный: повседневной
поднять: поднять
планка: планку
возможный: возможного
паралимпийские: паралимпийские
показывать: показывают
мы: нам
способный: способен
достигнуть: достичь
какой: какую
важный: важную важнейшим важными важное
этот: этих этими
выдаваться: выдающихся
заявить: заявил
директор: директор
тедрос: тедрос
адханом: адханом
гебрейесус: гебрейесус
многие: многие многих
сей: сих
пора: пор
ассистивным: ассистивным
высокий: высокой высочайших
стоимость: стоимости
недостаточный: недостаточного
предложение: предложения
призывать: призываем
страна: страны странах стран
донор: доноров
гражданский: гражданское
общество: общество
уделить: уделить
приоритетный: приоритетное
вопрос: вопросу вопросам вопросы
обеспечение: обеспечения обеспечение обеспечении
критически: критически
средство: средствами
включить: включить
программа: программы
первичный: первичной
медико-санитарный: медико-санитарной
движение: движения
охват: охвату охвата
услуга: услугами
один: одно
немногие: немногих
мероприятие: мероприятий
масштаб: масштаба
ограничить: ограниченными ограниченным
находиться: находятся
центр: центре центром
состязание: состязания
ход: ходе
служить: служат
наглядный: наглядной
демонстрация: демонстрацией
атлет: атлеты
мочь: могут
добиваться: добиваться
спортивный: спортивных
результат: результатов
отметить: отметил
председатель: председатель
эндрю: эндрю
парсонс: парсонс
позволять: позволяют
вдохновить: вдохновить
миллион: миллионы млн
все: всему всем
нуждаться: нуждаются
миллиард: млрд
оценка: оценкам
однако: однако
оставаться: остается
крайне: крайне
зависимость: зависимости
процент: процентов
необходимый: необходима
спрос: спрос
слуховой: слуховые
аппарат: аппараты
современный: современном
удовлетворить: удовлетворен
лишь: лишь
инвалидность: инвалидностью
оказываться: оказываются
лишить: лишенными
участвовать: участвовать
аспект: аспектах
подвергаться: подвергаются
больший: большему
риск: риску
социальный: социального социальному социальное
отчуждение: отчуждения
изоляция: изоляции
нищета: нищеты
успешный: успешных
отношение: отношении
такой: такие
недавний: недавняя
отмена: отмена
налоговый: налогов
зимбабве: зимбабве
снижение: снижение снижению
франция: франции
япония: японии
преддверие: преддверии
привлекать: привлекая
подобный: подобным
инициатива: инициативам
побуждать: побуждать
принятие: принятию
аналогичный: аналогичных
мера: мер меры
включение: включению
объем: объем
повышение: повышение повышению
цена: цен
давать: дают
вести: вести
полноценный: полноценную
индивидуальный: индивидуальном
уровень: уровне
способствовать: способствуют способствует
целый: целом
качественный: качественным
безопасный: безопасным безопасных
недорогой: недорогим
приводить: приводит
расход: расходов
например: например
связанный: связанных
периодический: периодической
госпитализация: госпитализацией
производительность: производительности
труд: труда
самый: самым
косвенно: косвенно
стимулировать: стимулируя
рост: рост
оказывать: оказывает
поддержка: поддержку
правительство: правительству
здоровый: здоровых
условие: условий условия
зритель: зрителей
частность: частности
совместно: совместно
европейский: европейским
профилактика: профилактике
контроль: контролю
заболевание: заболеваний
приехать: приехавших
подготовить: подготовлены
рекомендация: рекомендации
здоровье: здоровья
подписываться: подписывайтесь
наш: нашу наши
рассылка: рассылку
загружать: загружайте
приложение: приложение
мобильный: мобильных
предел: предел
покончить: покончить
ядерный: ядерными
испытание: испытаниями
навсегда: навсегда
инновационный: инновационный
индекс: индекс
лидировать: лидируют
китай: китай
сша: сша
жаркий: жаркая
погода: погода
влиять: влияет
беременность: беременность
два: две
будущее: будущие
мама: мамы
задавать: задают задаваемые
акушерка: акушерке
ресурс: ресурсы
партнер: партнеров
новостной: новостные
анонс: анонсы
журнал: журнал
отчет: отчеты
заседание: заседаниях
аудиовизуальный: аудиовизуальные
материал: материалы
общение: общение
твиттер: твиттер
последний: последние
главное: главные
брифинг: брифингов
стенограмма: стенограммы
комментарий: комментарии
журналист: журналистов
интернет: интернете
фейсбук: фейсбук
вконтакте: вконтакте
контакт: контакты
пользоваться: пользоваться
сайт: сайтом
указатель: указатель
часто: часто
остерегаться: остерегайтесь
мошенничество: мошенничества
конфиденциальность: конфиденциальность
пользование: пользования
пожертвование: пожертвования