собраться: собравшиеся
нью-йорк: нью-йорке
мировой: мировые мировыми
лидер: лидеры лидерами
пообещать: пообещали
принять: принять приняли приняты
мера: меры мер
борьба: борьбе борьбы
устойчивость: устойчивостью устойчивости устойчивость
антибиотик: антибиотикам антибиотики антибиотиков
новость: новости
оон: оон
перейти: перейти
основное: основному
добро: добро
пожаловать: пожаловать
русский: русский
другой: другие
глобальный: глобальный глобальных
взгляд: взгляд
человеческий: человеческие
судьба: судьбы
поиск: поиск
расширить: расширенный
язык: язык
меню: меню
главный: главная
азия: азия
америка: америка
африка: африка
ближний: ближний
восток: восток
европа: европа
тема: темы теме
гуманитарный: гуманитарная
помощь: помощь
беженец: беженцы
мигрант: мигранты
женщина: женщины
здравоохранение: здравоохранение здравоохранения
климат: климат
окружать: окружающая окружающей окружающую
среда: среда среде среду среды
культура: культура
образование: образование
международный: международное
правый: право права
мир: мир
безопасность: безопасность
генеральный: генеральный генерального
секретарить: секретарь секретаря
человек: человека людей людьми человеку
цель: цели целях
устойчивый: устойчивого
развитие: развития развитие развитии
экономический: экономическое
подробный: подробнее
интервью: интервью
сюжет: сюжеты
экспресс-новости: экспресс-новости
фоторепортаж: фоторепортажи
пресс-секретарь: пресс-секретарь
выступление: выступления
заявление: заявления
пресса: прессой
официальный: официальные
поездка: поездки
фотография: фотографии
пресс-релиз: пресс-релизы
группа: группа группы
аккредитация: аккредитации
сми: сми
интернет-трансляция: интернет-трансляция
аудиотека: аудиотека
подписаться: подписаться
сорин: сорин
декларация: декларации декларацию декларация
содержаться: содержится содержатся
призыв: призыв
выделить: выделить
миллион: млн миллиона миллионов
доллар: долларов
финансирование: финансирование финансирования
антимикробный: антимикробной антимикробную
резистентность: резистентностью резистентность
печать: печать
сентябрь: сентября
четверг: четверг
штаб-квартира: штаб-квартире
политический: политическую
который: которой которые которому которая
обязаться: обязались
достигнуть: достичь достигнута
конкретный: конкретных
целый: целей
частность: частности
сократить: сократить
смертность: смертность
процент: процентов
год: году лет
встреча: встреча
высокий: высокого
уровень: уровня
пройти: прошла
рамка: рамках
сессия: сессии сессия
генассамблея: генассамблеи
съехаться: съехались
общеполитический: общеполитические
дебаты: дебаты
противомикробный: противомикробным противомикробных противомикробная
препарат: препаратам препаратов
упп: упп
ежегодно: ежегодно
становиться: становится
непосредственный: непосредственной
причина: причиной
смерть: смертей
один: одним одной одно
фактор: фактором
пять: пяти
возникать: возникает
результат: результате
постепенный: постепенной
мутация: мутации
бактерия: бактерий
вирус: вирусов
грибок: грибков
паразит: паразитов
утрата: утраты
они: ими
восприимчивость: восприимчивости
лекарственный: лекарственным
затруднять: затрудняет
лечение: лечение лечении
инфекция: инфекций инфекции
повышать: повышает
риск: риски
распространение: распространения распространении распространение
тяжелый: тяжелого
течение: течения
летальный: летального
исход: исхода
болезный: болезней
агентство: агентства агентство
являться: являющиеся
участник: участниками
четырехстороннего: четырехстороннего
партнерство: партнерства
всемирный: всемирная
организация: организация
воз: воз
охрана: охране
здоровье: здоровья здоровье
животное: животных
воозж: воозж
продовольственный: продовольственная
сельскохозяйственный: сельскохозяйственная
фао: фао
юнеп: юнеп
приветствовать: приветствовали
достигнутый: достигнутое
сегодня: сегодня
соглашение: соглашение
столетие: столетие
тот: тех
пора: пор
александр: александр
флеминг: флеминг
наткнуться: наткнулся
пенициллин: пенициллин
лондонский: лондонской
лаборатория: лаборатории
стать: стали
основа: основой
медицина: медицины
превратить: превратив
некогда: некогда
смертельный: смертельные
излечимый: излечимые
состояние: состояния
сказать: сказал
тедрос: тедрос
адханом: адханом
гебрейесус: гебрейесус
директор: директор
грозить: грозит
свести: свести
прогресс: прогресс
сомнение: сомнения
делать: делает
самый: самых
острый: острых
проблема: проблем проблемы
наш: нашего наше нашу наши
временить: времени
сегодняшний: сегодняшняя
включать: включает
жизненно: жизненно
важный: важные
обязательство: обязательства
быть: будут
воплотить: воплощены
действие: действия действий
помочь: помогут помочь поможет
отслеживать: отслеживать
сдерживать: сдерживать
расширять: расширять
доступ: доступ доступа
такой: таким такое
стимулировать: стимулировать
разработка: разработку
новый: новых новая
добавить: добавил
какой: какие
звучать: звучит
страна: странам странах
целевой: целевого
показатель: показателя
менее: менее
государство: государств
должен: должны должна
профинансировать: профинансировать
национальный: национальные
план: планы
задача: задача
увеличение: увеличению
например: например
счет: счет
диверсификация: диверсификации
источник: источников
привлечение: привлечения
больший: большего
число: числа числе
вкладчик: вкладчиков
многопартнерский: многопартнерский
трастовый: трастовый
фонд: фонд
использовать: используемых
пациент: пациентов
подбираться: подбираться
минимальный: минимальными
побочный: побочными
эффект: эффектами
меньшой: меньшим
потенциал: потенциалом
возникновение: возникновения
медицинский: медицинские
учреждение: учреждения
обеспечить: обеспечены
базовый: базовыми
услуга: услугами
область: области
водоснабжение: водоснабжения
санитария: санитарии
гигиена: гигиены
удаление: удаления
отходы: отходов отходами
кроме: кроме
инвестиция: инвестициям
обеспечение: обеспечения обеспечению
справедливый: справедливого
надлежащий: надлежащего
использование: использования
касаться: касается
сельский: сельского
хозяйство: хозяйства
соответственно: соответственно
качество: качества качестве
продукт: продуктов продуктами
питание: питания
значительно: значительно
количество: количество
агропродовольственных: агропродовольственных
система: системах систем
зависеть: зависит
безопасный: безопасной безопасными
питательный: питательной питательными
пища: пищи
здоровый: здоровых
стабильный: стабильных
жизнестойкий: жизнестойких
инклюзивных: инклюзивных
протяжение: протяжении
неуклонно: неуклонно
выполнять: выполняет
миссия: миссию
полностью: полностью
поддерживать: поддерживаем
цюй: цюй
дунъюй: дунъюй
документ: документе
также: также
подчеркиваться: подчеркивается
необходимость: необходимость
решение: решения
выброс: выброса
создавать: создает
серьезный: серьезные
мочь: могут
попадать: попадать
организм: организм
вода: водой
появляться: появляется
доказательство: доказательств
играть: играет
значительный: значительную
роль: роль
передача: передаче
возбудитель: возбудителей
поэтому: поэтому
хотеть: хотим
снизить: снизить
связанный: связанные
защита: защита
часть: частью
признать: признает
заявить: заявила
исполнительный: исполнительный
ингер: ингер
андерсен: андерсен
официально: официально
закреплять: закрепляет
создание: создание
постоянный: постоянного
совместный: совместного
секретариат: секретариата
центральный: центрального
координационный: координационного
механизм: механизма
поддержка: поддержки
реагирование: реагирования
подписываться: подписывайтесь
рассылка: рассылку
загружать: загружайте
приложение: приложение
мобильный: мобильных
устройство: устройств
невидимый: невидимый
убийца: убийца
выпустить: выпустила
первое: первое
руководство: руководство
управление: управлению
производство: производства
инициатива: инициатива
бороться: бороться
будущее: будущими
пандемия: пандемиями
ресурс: ресурсы
информация: информация
партнер: партнеров
новостной: новостные
анонс: анонсы
журнал: журнал
отчет: отчеты
заседание: заседаниях
аудиовизуальный: аудиовизуальные
материал: материалы
общение: общение
твиттер: твиттер
последний: последние
главное: главные
брифинг: брифингов
стенограмма: стенограммы
комментарий: комментарии
журналист: журналистов
интернет: интернете
фейсбук: фейсбук
вконтакте: вконтакте
контакт: контакты
пользоваться: пользоваться
сайт: сайтом
указатель: указатель
часто: часто
задавать: задаваемые
вопрос: вопросы
остерегаться: остерегайтесь
мошенничество: мошенничества
конфиденциальность: конфиденциальность
условие: условия
пользование: пользования
пожертвование: пожертвования