число: число числа
смерть: смертей смерти смерть
утопление: утопления утоплений утопление утоплениям
европа: европе европа
сократиться: сократилось
процент: процентов процента процентами процентах
новость: новости новость
оон: оон
перейти: перейти
основное: основному основном
добро: добро
пожаловать: пожаловать
русский: русский
другой: другие других
глобальный: глобальный глобальном
взгляд: взгляд
человеческий: человеческие
судьба: судьбы
поиск: поиск
расширить: расширенный
язык: язык
меню: меню
главный: главная
азия: азия
америка: америка
африка: африка африке
ближний: ближний
восток: восток
тема: темы теме
гуманитарный: гуманитарная
помощь: помощь
беженец: беженцы
мигрант: мигранты
женщина: женщины
здравоохранение: здравоохранение здравоохранения
климат: климат
окружать: окружающая
среда: среда
культура: культура
образование: образование
международный: международное
правый: право права
мир: мир мире
безопасность: безопасность безопасности
генеральный: генеральный генерального
секретарить: секретарь секретаря
человек: человека человек людей
цель: цели
устойчивый: устойчивого
развитие: развития развитие
экономический: экономическое
подробный: подробнее
интервью: интервью
сюжет: сюжеты
экспресс-новости: экспресс-новости
фоторепортаж: фоторепортажи
пресс-секретарь: пресс-секретарь
выступление: выступления
заявление: заявления
пресса: прессой
официальный: официальные
поездка: поездки
фотография: фотографии
пресс-релиз: пресс-релизы
группа: группа
аккредитация: аккредитации
сми: сми
интернет-трансляция: интернет-трансляция
аудиотека: аудиотека
подписаться: подписаться
паэс: паэс
обучение: обучение обучения
ребенок: детей дети
плавание: плаванию плавания плавание
снижать: снижает
риск: риски риску риска рисками рисков
вод: воде
печать: печать
декабрь: декабря
сегодня: сегодня
всемирный: всемирная всемирный всемирным
организация: организация организациями организации организацией
воз: воз
опубликовать: опубликовала
свой: свой
первый: первый
история: истории
доклад: доклад докладе
профилактика: профилактике профилактики
немой: нем
сообщаться: сообщается
результат: результате
снизиться: снизилось снизился
уровень: уровне уровнем уровень
год: года году лет год
отмечать: отмечают
оставаться: остается остаются
серьезный: серьезной
проблема: проблемой проблеме
каждый: каждый каждая
час: час
тонуть: тонут
погибнуть: погибло погибнуть
тысяча: тысяч тысячи
половина: половина
случай: случаев
приходиться: приходится
возраст: возрасте возрастов
четверть: четверть
присмотр: присмотра
взрослый: взрослых
подверженный: подвержены
сам: самому
высокий: высокому высокий
значительный: значительное
снижение: снижение снижению
это: это
отличный: отличная
доказательство: доказательство
простой: простые
практический: практические
мера: меры мер
который: которые которой
рекомендовать: рекомендует рекомендованные
сработать: сработали
сказать: сказал
директор: директор
тедрос: тедрос
адханом: адханом
гебрейесус: гебрейесус
менее: менее
избежать: избежать
миллион: миллионы миллиона
зона: зоне зон
наш: нашем нашу наши
содержаться: содержатся
важный: важные
дать: данные данных
разработка: разработки
политик: политики
рекомендация: рекомендации рекомендациям
срочный: срочным
действие: действиям
спасение: спасения спасению
жизнь: жизней
добавить: добавил
прогресс: прогресс
сокращение: сокращении сокращению
неравномерный: неравномерным
говориться: говорится
происходить: происходят
страна: странах стран страны
низкий: низким
средний: средним
доход: дохода
европейский: европейском европейского
регион: регионе регионов региона
смертность: смертности
период: период
однако: однако
африканский: африканском
показатель: показатель
зафиксировать: зафиксирован
самый: самый
связанный: связано связанных
политика: политикой
сфера: сфере
национальный: национальная
стратегия: стратегия стратегию
план: план
сравнение: сравнению
майкл: майкл
блумберг: блумберг
посол: посол
неинфекционный: неинфекционным
заболевание: заболеваниям
травма: травмам
основатель: основатель
быть: бывший
мэр: мэр
нью-йорк: нью-йорка
подчеркнуть: подчеркнул
правительство: правительства
должен: должны
забывать: забывать
необходимость: необходимости необходимость
партнерство: партнерства
работать: работающими
десять: десяти
поддерживать: поддерживает
местный: местные
принимать: принимают
новый: новом новый
показать: показано
мочь: могут
сделать: сделать
помочь: помочь поможет
спасти: спасти
текущий: текущие
тенденция: тенденции
сохраниться: сохранятся
большинство: большинство
предотвратить: предотвратить
следовать: следовать
предлагать: предлагаемых
установка: установка установке
ограждение: ограждений ограждении
воды: воды
обязательный: обязательное обязательного
создание: создание
безопасный: безопасных безопасного
игровой: игровых
вдали: вдали
реанимация: реанимации
повышение: повышение
осведомленность: осведомленности осведомленность
общество: общества
введение: введение
обеспечение: обеспечение
соблюдение: соблюдения
править: правил
лодка: лодках
средство: средствах
водный: водного водном
транспорт: транспорта транспорте
также: также
эффективный: эффективное
управление: управление
наводнение: наводнений наводнениями
разный: разных разной
реализоваться: реализуются
степень: степени
иметься: имеются
необходимый: необходимые необходимую
поисково-спасательный: поисково-спасательные
служба: службы
государство: государств
реализовать: реализуют
программа: программы
существовать: существуют
население: населения
навык: навыкам
включить: включено
школьный: школьные
требовать: требуют
использование: использования
спасательный: спасательных
жилет: жилетов
прогулочный: прогулочных
отсутствовать: отсутствуют
закон: законы
бассейн: бассейнов
сбор: сбора
точный: точная
информация: информация
повысить: повысить
разработать: разработать
собирать: собирают
подписываться: подписывайтесь
рассылка: рассылку
загружать: загружайте
приложение: приложение
мобильный: мобильных
устройство: устройств
июль: июля
деть: день
предотвращение: предотвращения
провозгласить: провозгласили
днем: днем
одобрить: одобрила
революционный: революционный
тест: тест
туберкулез: туберкулез
ресурс: ресурсы
партнер: партнеров
новостной: новостные
анонс: анонсы
журнал: журнал
отчет: отчеты
заседание: заседаниях
аудиовизуальный: аудиовизуальные
материал: материалы
общение: общение
твиттер: твиттер
последний: последние
главное: главные
брифинг: брифингов
стенограмма: стенограммы
комментарий: комментарии
журналист: журналистов
интернет: интернете
фейсбук: фейсбук
вконтакте: вконтакте
контакт: контакты
пользоваться: пользоваться
сайт: сайтом
указатель: указатель
часто: часто
задавать: задаваемые
вопрос: вопросы
остерегаться: остерегайтесь
мошенничество: мошенничества
конфиденциальность: конфиденциальность
условие: условия
пользование: пользования
пожертвование: пожертвования