газ: газе газа газы
подтвердить: подтвержден подтвердить
первый: первый
случай: случай
полиомиелит: полиомиелита полиомиелит
новость: новости
оон: оон
перейти: перейти
основное: основному
добро: добро
пожаловать: пожаловать
русский: русский
другой: другие
глобальный: глобальный
взгляд: взгляд
человеческий: человеческие
судьба: судьбы
поиск: поиск поисках
расширить: расширенный
язык: язык
меню: меню
главный: главная
азия: азия
америка: америка
африка: африка
ближний: ближний ближайшие
восток: восток
европа: европа
тема: темы теме
гуманитарный: гуманитарная гуманитарных гуманитарным гуманитарную
помощь: помощь помощью помощи
беженец: беженцы беженцев
мигрант: мигранты
женщина: женщины
здравоохранение: здравоохранение здравоохранения
климат: климат
окружать: окружающая
среда: среда
культура: культура
образование: образование
международный: международное
правый: право права
мир: мир
безопасность: безопасность безопасности
генеральный: генеральный генерального
секретарить: секретарь секретаря
человек: человека человек людей
цель: цели целью
устойчивый: устойчивого
развитие: развития развитие
экономический: экономическое
подробный: подробнее
интервью: интервью
сюжет: сюжеты
экспресс-новости: экспресс-новости
фоторепортаж: фоторепортажи
пресс-секретарь: пресс-секретарь
выступление: выступления
заявление: заявления
пресса: прессой
официальный: официальные
поездка: поездки
фотография: фотографии
пресс-релиз: пресс-релизы
группа: группа
аккредитация: аккредитации
сми: сми
интернет-трансляция: интернет-трансляция
аудиотека: аудиотека
подписаться: подписаться
фото: фото
бапор: бапор
ребенок: детям ребенка дети детей
приходиться: приходится
жить: жить
антисанитарный: антисанитарных
условие: условиях условия
печать: печать
август: августа августе
впервые: впервые
год: лет
сектор: секторе
зафиксировать: зафиксирован
опасный: опасная
инфекция: инфекция инфекции
выявить: выявлена
десятимесячного: десятимесячного
мальчик: мальчика
готовиться: готовятся
масштабный: масштабной
кампания: кампании
вакцинация: вакцинации
предотвратить: предотвратить
распространение: распространение распространения
вирус: вируса
глава: глава
всемирный: всемирной
организация: организации организаций
воз: воз
тедрос: тедрос
адханом: адханом
гебрейесус: гебрейесус
выразить: выразил
это: этому этим
повод: поводу
глубокий: глубокую
обеспокоенность: обеспокоенность
сообщить: сообщил
дейр-эль-балахе: дейр-эль-балахе
развиться: развился
паралич: паралич
нижний: нижней
частить: части
левый: левой
нога: ноги
находиться: находится
стабильный: стабильном
состояние: состоянии
добавить: добавил
геномного: геномного
секвенирования: секвенирования
эксперт: экспертам
удаться: удалось
связанный: связана
вариант: вариантом
полиовируса: полиовируса
тип: типа
обнаружить: обнаруженным
июнь: июне
сточный: сточных
воды: водах
угроза: угроза
учитывать: учитывая
высокий: высокий
риск: риск
все: всем
регион: регионе
палестинский: палестинские палестинских палестинской
орган: органы
вместе: вместе
детская: детским
фонд: фондом
юнисеф: юнисеф
неделя: недели
начать: начнут
агентство: агентство агентством агентства
дело: делам
оказать: окажет
содействие: содействие
усилие: усилиям
число: числе
помочь: помогут
доставка: доставкой
вакцина: вакцин
напомнить: напомним
являться: является
крупный: крупнейшим
оказание: оказанию
настоящее: настоящее
время: время
сотрудник: сотрудники
предоставлять: предоставляют
медицинский: медицинские медицинских медицинскую
услуга: услуги
десять: десяти
центр: центрах
первичный: первичной
медико-санитарный: медико-санитарной
также: также
передвижной: передвижных
пункт: пунктах
массовый: массовые массовой
перемещение: перемещения
по-прежнему: по-прежнему
крайне: крайне
обеспокоить: обеспокоены
эвакуация: эвакуацией эвакуации
житель: жителей
который: которым которые которая
переезжать: переезжать
место: места место
существенно: существенно
осложнять: осложняют
задача: задачу
израильский: израильские
сила: силы
издать: издали
приказ: приказов приказы
вынудить: вынудив
очередной: очередной
сняться: сняться
муханнад: муханнад
хади: хади
координатор: координатор
вопрос: вопросам вопросы
оккупировать: оккупированной
территория: территории
предназначить: предназначены
защита: защиты
гражданский: гражданского
население: населения
суть: сути
вести: ведут
прямой: прямо
противоположный: противоположному
результат: результату
подчеркнуть: подчеркнул
вынуждать: вынуждают
бежать: бежать
часто: часто
обстрел: обстрелами
тот: теми
вещь: вещами
мочь: могут
унести: унести
себя: собой
селиться: селиться
ограничить: ограниченной
площадь: площади
переселить: переселенной
загрязненный: загрязненной
весь: вся
небезопасный: небезопасна
слово: словам
постоянный: постоянные
переселение: переселения
лишать: лишают
возможность: возможности
получать: получать
поддержка: поддержку
пользоваться: пользоваться
самый: самыми
элементарный: элементарными
удобство: удобствами
подписываться: подписывайтесь
наш: нашу наши
рассылка: рассылку
загружать: загружайте
приложение: приложение
мобильный: мобильных
устройство: устройств
охватить: охваченном
боев: боевыми
действие: действиями
север: севере
анклав: анклава
привить: привить
тысяча: тысячи
израиль: израилем
достигнуть: достигнуто
соглашение: соглашение
пауза: паузах
проведение: проведения
готовый: готово
ресурс: ресурсы
информация: информация
партнер: партнеров
новостной: новостные
анонс: анонсы
журнал: журнал
отчет: отчеты
заседание: заседаниях
аудиовизуальный: аудиовизуальные
материал: материалы
общение: общение
твиттер: твиттер
последний: последние
главное: главные
брифинг: брифингов
стенограмма: стенограммы
комментарий: комментарии
журналист: журналистов
интернет: интернете
фейсбук: фейсбук
вконтакте: вконтакте
контакт: контакты
сайт: сайтом
указатель: указатель
задавать: задаваемые
остерегаться: остерегайтесь
мошенничество: мошенничества
конфиденциальность: конфиденциальность
пользование: пользования
пожертвование: пожертвования