всемирный: всемирный
деть: день
психический: психического психическое психическому психическом
здоровье: здоровья здоровью здоровье
обеспечить: обеспечить
квалифицированный: квалифицированную
помощь: помощь
каждый: каждому каждого каждый
нуждаться: нуждающемуся
новость: новости
оон: оон
перейти: перейти
основное: основному
добро: добро
пожаловать: пожаловать
русский: русский
другой: другие
глобальный: глобальный
взгляд: взгляд
человеческий: человеческие человеческих
судьба: судьбы
поиск: поиск
расширить: расширенный
язык: язык
меню: меню
главный: главная
азия: азия
америка: америка
африка: африка
ближний: ближний
восток: восток
европа: европа
тема: темы теме
гуманитарный: гуманитарная
беженец: беженцы
мигрант: мигранты
женщина: женщины
здравоохранение: здравоохранение
климат: климат
окружать: окружающая
среда: среда
культура: культура
образование: образование
международный: международное
правый: право права
мир: мир мире
безопасность: безопасность
генеральный: генеральный генерального
секретарить: секретарь секретаря
человек: человека людей людям человек
цель: цели
устойчивый: устойчивого
развитие: развития развитие
экономический: экономическое
подробный: подробнее
интервью: интервью
сюжет: сюжеты
экспресс-новости: экспресс-новости
фоторепортаж: фоторепортажи
пресс-секретарь: пресс-секретарь
выступление: выступления
заявление: заявления
пресса: прессой
официальный: официальные
поездка: поездки
фотография: фотографии
пресс-релиз: пресс-релизы
группа: группа группах
аккредитация: аккредитации
сми: сми
интернет-трансляция: интернет-трансляция
аудиотека: аудиотека
подписаться: подписаться
возч: возч
тефавал: тефавал
примерный: примерно
восьмой: восьмого
планет: планете
расстройство: расстройство расстройства
печать: печать
октябрь: октября
целый: целом
отмечать: отмечают
напомнить: напомнил
свое: своем свои своих своему
послание: послании
говориться: говорится
антониу: антониу
гутерриша: гутерриша
такой: такие
встречаться: встречаются
любой: любых
общество: обществах
один: одной
основной: основных основную
причина: причин
смерть: смерти
молодой: молодого
поколение: поколения
оставаться: остается
суицид: суицид
миллион: миллионы
продолжать: продолжают
переносить: переносить
страдание: страдания
молча: молча
год: году лет
посвятить: посвящен
внимательный: внимательному
отношение: отношению
рабочий: рабочем рабочие рабочая рабочий
место: месте места
шестьдесят: шестьдесят
процент: процентов
старший: старше
работать: работают
проводить: проводят
часть: часть
временить: времени
однако: однако
это: это
пространство: пространства
который: которых
выполнять: выполняем
должностной: должностные
обязанность: обязанности
нечто: нечто
горазд: гораздо
больший: большее
отметить: отметил
генсек: генсек
безопасный: безопасная
здоровый: здоровая
обстановка: обстановка
позволять: позволяет позволяющими
ощущать: ощущать
осмысленность: осмысленность
свой: своей
деятельность: деятельности
создавать: создает
чувство: чувство
общность: общности
стабильность: стабильности
время: время
угнетать: угнетающая
хаотичный: хаотичная
крайне: крайне
пагубный: пагубно
сказываться: сказываться
тот: тех
пора: пор
вместе: вместе
пандемия: пандемией
наступить: наступила
новый: новая
эпоха: эпоха
удаленный: удаленной
работа: работы работой работа
граница: границы
дом: домом
сильный: сильнее
размываться: размываются
связь: связи
охрана: охрана охраны
персонал: персонала
становиться: становится
непростой: непростой
задача: задачей
иметь: имеет имел
большой: большое
значение: значение
общий: общего общее
самочувствие: самочувствия самочувствие
подчеркнуть: подчеркнул
гутерриш: гутерриш
работодатель: работодатели
принимать: принимают
мера: меры
устранение: устранению
риск: рисков
сотрудник: сотрудников
организация: организаций
укреплять: укрепляет
моральный: моральный
дух: дух
уменьшать: уменьшает
число: число
случай: случаев
систематический: систематического
отсутствие: отсутствия
повышать: повышает
вовлеченность: вовлеченность
процесс: процесс
производительность: производительность
труд: труда
слово: словам слово
глава: главы
необходимо: необходимо
предел: пределами
обладать: обладал
знание: знаниями
ресурс: ресурсами ресурсы
уделять: уделять
пристальный: пристальное
внимание: внимание
также: также
возможность: возможность
пользоваться: пользоваться
качественный: качественными
услуга: услугами
область: области
сталкиваться: сталкиваясь
стигматизация: стигматизацией
препятствие: препятствиями
подписываться: подписывайтесь
наш: нашу наши
рассылка: рассылку
загружать: загружайте
приложение: приложение
мобильный: мобильных
устройство: устройств
теракт: теракта
воз: воз
помогать: помогает
израильский: израильским
спасатель: спасателям
справиться: справиться
психологический: психологическими
травма: травмами
предотвращение: предотвращения
утопление: утоплений
знать: знать
спасение: спасения
жизнь: жизней жизнь
мочь: могут
спасти: спасти
информация: информация
партнер: партнеров
новостной: новостные
анонс: анонсы
журнал: журнал
отчет: отчеты
заседание: заседаниях
аудиовизуальный: аудиовизуальные
материал: материалы
общение: общение
твиттер: твиттер
последний: последние
главное: главные
брифинг: брифингов
стенограмма: стенограммы
комментарий: комментарии
журналист: журналистов
интернет: интернете
фейсбук: фейсбук
вконтакте: вконтакте
контакт: контакты
сайт: сайтом
указатель: указатель
часто: часто
задавать: задаваемые
вопрос: вопросы
остерегаться: остерегайтесь
мошенничество: мошенничества
конфиденциальность: конфиденциальность
условие: условия
пользование: пользования
пожертвование: пожертвования