швеция: швеции швеция
подтвердить: подтвержден подтвержденном
случай: случай случае
заболевание: заболевания заболеваний
оспа: оспой оспы оспа
обезьяна: обезьян
первый: первый первую
предел: пределами
африканский: африканского
регион: региона регионах региону
новость: новости
оон: оон
перейти: перейти
основное: основному
добро: добро
пожаловать: пожаловать
русский: русский
другой: другие других
глобальный: глобальный
взгляд: взгляд
человеческий: человеческие
судьба: судьбы
поиск: поиск
расширить: расширенный расширить
язык: язык
меню: меню
главный: главная
азия: азия
америка: америка
африка: африка африки африке
ближний: ближний
восток: восток
европа: европа европе
тема: темы теме
гуманитарный: гуманитарная
помощь: помощь
беженец: беженцы
мигрант: мигранты
женщина: женщины
здравоохранение: здравоохранение здравоохранения
климат: климат
окружать: окружающая
среда: среда среду
культура: культура
образование: образование
международный: международное международного
правый: право права
мир: мир мира
безопасность: безопасность
генеральный: генеральный генерального
секретарить: секретарь секретаря
человек: человека человек людям
цель: цели
устойчивый: устойчивого
развитие: развития развитие
экономический: экономическое
подробный: подробнее
интервью: интервью
сюжет: сюжеты
экспресс-новости: экспресс-новости
фоторепортаж: фоторепортажи
пресс-секретарь: пресс-секретарь
выступление: выступления
заявление: заявления
пресса: прессой
официальный: официальные
поездка: поездки
фотография: фотографии
пресс-релиз: пресс-релизы
группа: группа
аккредитация: аккредитации
сми: сми
интернет-трансляция: интернет-трансляция
аудиотека: аудиотека
подписаться: подписаться
предыдущий: предыдущая предыдущей
вспышка: вспышка вспышку вспышки
вызвать: вызвана
менее: менее
опасный: опасным
штамм: штаммом штамм
печать: печать
август: августа
власть: власти
сообщить: сообщили
страна: стране страны
первое: первом
накануне: накануне
всемирный: всемирная
организация: организация
объявить: объявила
болезнь: болезни
чрезвычайный: чрезвычайной
ситуация: ситуацией ситуаций
значение: значения значение
дать: данным данный
шведский: шведских шведские
орган: органов органы
инфицированный: инфицированный
посетить: посетил
район: район
зарегистрировать: зарегистрировано
распространение: распространение
отмечать: отмечали
ранее: ранее
лишь: лишь
вопрос: вопросом вопросы
временить: времени
клад: клада
примред: примред
который: которая
по-видимому: по-видимому
серьезный: серьезна
обнаружить: обнаружена
воз: воз
учитывать: учитывая
взаимосвязанность: взаимосвязанность
наш: нашего нашу наши
написать: написал
свой: своей
страница: странице
платформа: платформе
директор: директор
региональный: регионального
бюро: бюро
ханс: ханс
клюге: клюге
момент: момент
проходить: проходит
лечение: лечение
приниматься: принимаются
также: также
стандартный: стандартные
такой: таких
мера: меры
включать: включая
изоляция: изоляцию
пациент: пациента
отслеживание: отслеживание
контакт: контактов контакты
подчеркивать: подчеркивают
угроза: угроза
широкий: широкой
общественность: общественности общественность
оставаться: остается
низка: низкой
бдительность: бдительность
иметь: имеет
решающий: решающее
призвать: призвал
относиться: относящиеся
европейский: европейскому европейского
усилить: усилить
выявление: выявлению
выпустить: выпустить
необходимый: необходимые
рекомендация: рекомендации
население: населения
доступ: доступ
вакцина: вакцинам
противовирусный: противовирусным
препарат: препаратам
читать: читайте
последний: последнюю последние
очередь: очередь
призывать: призываю
правительство: правительства
целый: целом
стигматизировать: стигматизировать
дискриминировать: дискриминировать
отдельный: отдельных
лицо: лиц
сообщество: сообщества сообществами
затронуть: затронутые
сказать: сказал
напомнить: напомнил
аналогичный: аналогичным
призыв: призывом
выступать: выступала
время: время
год: году
значительный: значительной
степень: степени
пострадать: пострадали
мужчина: мужчины мужчинами
вступать: вступающими
интимный: интимные
связь: связи
удаться: удалось
быстро: быстро
остановить: остановить
взаимодействие: взаимодействию
партнерство: партнерству
предоставить: предоставило
возможность: возможность
взять: взять
ответственность: ответственность
свое: свое
здоровье: здоровье здоровья
принять: принять
соответствующий: соответствующие
защитный: защитные
создать: создать
благоприятный: благоприятную
способствовать: способствующую
оптимальный: оптимальным
результат: результатам
отношение: отношении
отмечаться: отмечается
получить: получившим
название: название
подписываться: подписывайтесь
рассылка: рассылку
загружать: загружайте
приложение: приложение
мобильный: мобильных
устройство: устройств
усиливать: усиливает
сдерживание: сдерживанию
рекомендовать: рекомендует
массовый: массовую
вакцинация: вакцинацию
глава: глава
осенне-зимний: осенне-зимний
период: период
ожидаться: ожидается
рост: рост
ресурс: ресурсы
информация: информация
партнер: партнеров
новостной: новостные
анонс: анонсы
журнал: журнал
отчет: отчеты
заседание: заседаниях
аудиовизуальный: аудиовизуальные
материал: материалы
общение: общение
твиттер: твиттер
главное: главные
брифинг: брифингов
стенограмма: стенограммы
комментарий: комментарии
журналист: журналистов
интернет: интернете
фейсбук: фейсбук
вконтакте: вконтакте
пользоваться: пользоваться
сайт: сайтом
указатель: указатель
часто: часто
задавать: задаваемые
остерегаться: остерегайтесь
мошенничество: мошенничества
конфиденциальность: конфиденциальность
условие: условия
пользование: пользования
пожертвование: пожертвования