миф: мифов миф мифы
половой: половом половым половое полового половому
воспитание: воспитании воспитание воспитания воспитанию
нужно: нужно
ребенок: детям детей дети ребенком детьми ребенка
знать: знать знала знаю
секс: сексе секс сексу сексом
новость: новости новость
оон: оон
перейти: перейти
основное: основному
добро: добро
пожаловать: пожаловать
русский: русский
другой: другие другими другим других
глобальный: глобальный глобальном
взгляд: взгляд взглядов
человеческий: человеческие
судьба: судьбы
поиск: поиск
расширить: расширенный
язык: язык
меню: меню
главный: главная
азия: азия
америка: америка
африка: африка
ближний: ближний
восток: восток
европа: европа
тема: темы теме
гуманитарный: гуманитарная
помощь: помощь помощью
беженец: беженцы
мигрант: мигранты
женщина: женщины женщин женщинам
здравоохранение: здравоохранение
климат: климат
окружать: окружающая
среда: среда
культура: культура культуре
образование: образование образования
международный: международное
правый: право права прав
мир: мир миру мира
безопасность: безопасность безопасности
генеральный: генеральный генерального
секретарить: секретарь секретаря
человек: человека людей людям человек люди людьми человеку
цель: цели цель целью
устойчивый: устойчивого
развитие: развития развитие
экономический: экономическое
подробный: подробнее
интервью: интервью
сюжет: сюжеты
экспресс-новости: экспресс-новости
фоторепортаж: фоторепортажи
пресс-секретарь: пресс-секретарь
выступление: выступления
заявление: заявления
пресса: прессой
официальный: официальные
поездка: поездки
фотография: фотографии
пресс-релиз: пресс-релизы
группа: группа группы
аккредитация: аккредитации
сми: сми
интернет-трансляция: интернет-трансляция
аудиотека: аудиотека
подписаться: подписаться
юнфпаяфигула: юнфпаяфигула
комплексный: комплексное комплексного
сексуальный: сексуальное сексуального сексуальном сексуальных сексуальной сексуальным
вести: ведет
снижение: снижению
показатель: показателей показатели
подростковый: подростковой подросткового подростковую подростков подростковом подростковых
беременность: беременности беременность
насилие: насилия насилие насилию
печать: печать
сентябрь: сентября
распространение: распространения распространение
болезный: болезней
передаваться: передающихся
путем: путем
такой: такого таких такие таким такое
познакомить: познакомить
эмоциональный: эмоциональным
физический: физическим
социальный: социальным социальных
аспект: аспектами
сексуальность: сексуальности сексуальностью сексуальность
помочь: помочь помогли
подготовиться: подготовиться
будущее: будущему
оно: оно
учить: учит учили
молодая: молодых молодым молодые молодыми
тот: тому
строить: строить
здоровый: здоровые здоровым здоровых
отношение: отношения отношений отношениях
распознавать: распознавать
противостоять: противостоять
давление: давлению
сверстник: сверстников сверстники
понимать: понимать понимала
концепция: концепцию
согласие: согласия
неотъемлемый: неотъемлемой
часть: частью частях
протяжение: протяжении
десятилетие: десятилетий
правильный: правильной
реализация: реализации
тинейджер: тинейджерами
работать: работают работает работала
специальный: специально специальных
обученный: обученные
опытный: опытные
преподаватель: преподаватели преподаватель
адаптировать: адаптировано
возраст: возрасту возрасте возраста возрастов
предоставлять: предоставляет предоставляют
точный: точную
непредвзятый: непредвзятую
информация: информацию информации информация
гарантировать: гарантируя
прийтись: придется пришлось
обращаться: обращаться
порнография: порнографии
слух: слухам
ненадежный: ненадежным
онлайн-источникам: онлайн-источникам
узнать: узнать узнала
юнфпа: юнфпа
агентство: агентство
вопрос: вопросам вопросы
репродуктивный: репродуктивного репродуктивном
здоровье: здоровья здоровье
правительство: правительствами
все: всему
обеспечить: обеспечить
всесторонний: всестороннее всестороннему всестороннего
школа: школах школе школу школами школы
предел: пределами
посредство: посредством
обучение: обучения обучение
уровень: уровне уровню
сообщество: сообществ сообществе сообществах сообществами сообщества
некоторые: некоторых
страна: странах стране страны
идея: идея
сталкиваться: сталкивается сталкивалась сталкиваются
противодействие: противодействием
последний: последние
год: годы лет году
чаща: чаще
политизировать: политизируют
национальный: национальном национальный
региональный: региональном
контекст: контекстах
многие: многих многие
существовать: существует
консенсус: консенсус
относительно: относительно
решить: решить
ряд: ряд
серьезнейший: серьезнейших
проблема: проблем проблемы проблемами
включать: включая
гендерный: гендерное гендерного гендерную гендерным
предприниматься: предпринимается
усилие: усилий
посеять: посеять
сомнение: сомнения
родитель: родителей родителям родители
опекун: опекунов
риторика: риторика
противник: противников
оставаться: остается
последовательный: последовательной
аргумент: аргументы
иметь: имеют имеет
общий: общего
реальность: реальностью
распространить: распространенных
развеять: развеянных развеять
специалист: специалистами
предрасположенный: предрасположены
стать: стать стала
жертва: жертвами
правда: правда
защищать: защищает
рассказывать: рассказывает
угроза: угрозах
хищничество: хищничество
груминг: груминг
установление: установление
взрослый: взрослым взрослых
близкие: близких близкие
доверительный: доверительных
завоевание: завоевания
доверие: доверия
последующий: последующего
совращение: совращения
примред: примред
случай: случаях случае
каждый: каждый каждом
должен: должен
тело: тело теле
принадлежать: принадлежит
никто: никто
вмешиваться: вмешиваться
сказать: сказала
рабаа: рабаа
гесми: гесми
прошедший: прошедшая прошедшие
курс: курсах курс курса
сусе: сусе
тунис: тунис
зандил: зандил
симелане: симелане
активистка: активистка активисткой
защита: защите защиты
молодежь: молодежи молодежь
дурбан: дурбане
южный: южная
рассказать: рассказала рассказал
сам: самой
мочь: могло могли можем могут
полезно: полезно
подросток: подростком подросткам подростками подростки
жизнь: жизнь жизни
перевернуться: перевернулась
поставить: поставили
диагноз: диагноз
вич: вич
поделиться: поделилась
этот: эта этих
шокировать: шокировала
девушка: девушку девушка
учиться: училась
урок: уроков уроки
маленький: мало маленькой меньше
метод: методах
контрацепция: контрацепции контрацепция
защитить: защитить
посягательство: посягательств
сторона: стороны стороне
хищнический: хищнически
настроить: настроенных
откуда: откуда
это: это этим
благословлять: благословляющего благословляющий благословляет
говорить: говорит говорим
термин: термин
который: который которым которое которые которая которую
использоваться: использовался
описание: описания
пожилой: пожилого
мужчина: мужчины
девочка: девочек девочку девочки
бедный: бедных
семья: семей семьи
мобильный: мобильными мобильного мобильных
телефон: телефонами
деньга: деньгами
подарок: подарками
часто: часто
обмен: обмен
произойти: произошло
активно: активно
участвовать: участвовать
молодежный: молодежных
организация: организациях организацией
поддерживать: поддерживаемую поддерживаемая
африканский: африканскую
сеть: сеть сетей
история: историю
избежать: избежать
подобный: подобного подобная
опыт: опыта опыт
юнфпадабси: юнфпадабси
воздержание: воздержание воздержанию воздержания
эффективный: эффективно
отрицательный: отрицательные
последствие: последствия последствий
хороший: лучшем
отсутствие: отсутствие отсутствии
какой: каких
исключительно: исключительно
задокументированы: задокументированы
снижать: снижает
инфекция: инфекций
прививать: прививают
принцип: принцип принципах
реж: реже
использовать: используют
контрацептив: контрацептивы
подверженный: подвержены
высокий: высокому выше
риск: риску
заражение: заражения
вирус: вирусом
папиллома: папилломы
также: также
внебрачный: внебрачной
тири: тири
янгоны: янгоны
мьянма: мьянма
забеременеть: забеременела
мой: моим
парень: парнем
влюбить: влюблены
друг: друг друга
очень: очень
теплый: теплые
изменить: изменила изменить
опустошить: опустошена
нравиться: нравилось нравится
ходить: ходить
бросить: бросить
учеба: учебу
быстро: быстро
оформить: оформили
брак: брак
переехать: переехала
муж: мужа муж
родить: родила
закончить: закончил
уехать: уехал
дома: дома
продолжить: продолжить
редко: редко
слышать: слышала
немой: нем
распасться: распался
повезти: повезло
мать: мать матери
несмотря: несмотря
стереотип: стереотипы
стигматизация: стигматизацию стигматизации
общество: обществе
вместе: вместе
дочка: дочкой
вернуться: вернулись
домыть: домой
планировать: планирует
подчеркивать: подчеркивает
вещь: вещам
где-либо: где-либо
возможный: возможных возможное
наш: нашей нашу наши
любовь: любви
добавлять: добавляет
поощрять: поощряет
ранний: раннему раннем
заводить: заводить
больший: большее
число: число
партнер: партнеров партнером
исследование: исследования
показывать: показывают
поздний: позже
начинать: начинают
заниматься: заниматься занимающихся
жительница: жительница
вьетнам: вьетнама
линь: линь
хоанг: хоанг
найти: нашла найти
инновационный: инновационный
способ: способ
соответствующий: соответствующей соответствующие
основатель: основатель
директор: директор
платформа: платформы
помогать: помогает помогают
проводить: проводить проводимым
обучать: обучаемых
приложение: приложения приложение
охватывать: охватывает
личной: личная
гигиена: гигиена
слово: словам
партнерство: партнерству
местный: местными местных местной местная
педагог: педагогами педагоги
проект: проекте проекта
принять: приняли
участие: участие
позволить: позволило
восприятие: восприятие
побудить: побудило
обсуждение: обсуждениям
противоречить: противоречит
религия: религии
программа: программа программу программы
подбираться: подбирается
регион: региона
учет: учетом
условие: условий условия
традиция: традиций традиции
преподаваться: преподается
поддержка: поддержке поддержку
культурный: культурных
лидер: лидеров
например: например
бутан: бутане
монах: монахами монахов
изменение: изменение
мышление: мышлении
свободно: свободно
обсуждать: обсуждают
прошлый: прошлом
восприниматься: воспринимались
что-то: что-то
частное: частное
первое: первых
поддержать: поддержавших
инициатива: инициативу инициатива
лопен: лопен
шераб: шераб
дорджи: дорджи
центральный: центрального
монашеский: монашеского
корпус: корпуса
монахиня: монахини
пройти: прошли пройти
играть: играют
важный: важную важно
роль: роль
свое: своих своем свое
передавать: передавая
сельский: сельским
знание: знания
менструальный: менструальная
планирование: планирование
индий: индии
соглашение: соглашение
должностной: должностными
лицо: лицами
сфера: сфере
штат: штате
бихар: бихар
привести: привело приведут
традиционный: традиционные
исламский: исламские
институт: институты
запустить: запустили
предоставление: предоставлению
поощрение: поощрения
навык: навыков навыки
реагирование: реагирования
трудный: трудные
жизненный: жизненные
ситуация: ситуации
университет: университет
джамия: джамия
миллия: миллия
исламия: исламия
нью-дели: нью-дели
урду: урду
мауланы: мауланы
азад: азад
хайдарабад: хайдарабаде
развернуть: развернуть
десятка: десятки
тысяча: тысяч
сестра: сестры
дивия: дивия
сания: сания
получить: получили
рамка: рамках
пропагандировать: пропагандирует
образ: образ
лгбткиа: лгбткиа
учащийся: учащихся
какой-либо: какой-либо
конкретный: конкретный
благополучие: благополучие
менее: менее
признать: признает
необходимость: необходимость необходимостью необходимости
зависимость: зависимости
пол: пола
ориентация: ориентации
кьял: кьял
син: син
хтет: хтет
мона: мон
детство: детстве
постоянно: постоянно
дискриминация: дискриминацией дискриминации
изоляция: изоляцией
осознать: осознала
идентичность: идентичность
исследовать: исследовала исследовать
пользоваться: пользоваться
макияж: макияжем
свой: своей свой
реакция: реакция
последовать: последовала
немедленно: немедленно
полный: полный полного
издевательство: издевательств
травля: травли
сформировать: сформировал
решимость: решимость
сотрудничать: сотрудничает сотрудничающая
являться: является
распространять: распространяет распространяют
оказывать: оказывает
население: населению населения
связанный: связанным связанными
равенство: равенством
право: правами
делать: делает делать
создать: создать
пространство: пространство пространствах
диалог: диалога
сексуализирует: сексуализирует
лишать: лишает
невинность: невинности
какой-то: какой-то
момент: момент
столкнуться: столкнутся
мы: нам нами
поэтому: поэтому
крайне: крайне
информировать: информированы
готовый: готовы
решение: решению
давать: дает дают
избегать: избегать
ответственный: ответственный
выбор: выбор
представитель: представителей представитель
маргинализированных: маргинализированных
республика: республике
молдова: молдова
цыганский: цыганская цыганского цыганской
бежать: бежавшая
война: войны
украина: украине
проходить: проходит проходят
безопасный: безопасных
создаваемый: создаваемых
получать: получает получают
услуга: услуги услуг
первый: первая первый
род: рода
практиковаться: практиковались
координатор: координатор
сахин: сахин
рэдица: рэдица
отметить: отметив
долгий: долгое
время: время
считаться: считалось
табу: табу
община: общины
обеспечивать: обеспечивает
баланс: баланс
потребность: потребностью
уважать: уважать
ценность: ценности
цыган: цыган
сначала: сначала
скептический: скептически
относиться: относились
мероприятие: мероприятиям мероприятий
увидеть: увидели
эффект: эффект
добиться: добились
стабильный: стабильной
посещаемость: посещаемости
слишком: слишком
рано: рано
знакомить: знакомит
неподобающий: неподобающим
материал: материалом материалы
соответствовать: соответствует
склонный: склонны
прислушиваться: прислушиваться
недостоверный: недостоверной
пользователь: пользователи
интернет: интернета интернете
ангола: анголе
просвещать: просвещает просвещать
готовить: готовит
становиться: становились
проводник: проводниками
достоверный: достоверных
дать: данных
менять: меняет
расширять: расширяет
возможность: возможности
сильвий: сильвия
франциско: франциско
город: города
луанда: луанда
преодолеть: преодолеть
глубоко: глубоко
укорениться: укоренившиеся
постоянный: постоянная
борьба: борьба
думать: думают
разговор: разговоры
отсрочка: отсрочки
сенегал: сенегале
-летняя: -летняя
хади: хади
записаться: записалась
гинекологический: гинекологический
осмотр: осмотр
посещение: посещения
сложно: сложно
мастурбация: мастурбацию
понять: понять
нормальный: нормальная
практик: практика
обучаться: обучаются
отвечать: отвечать
деликатный: деликатные
поднимать: поднимаемые
ход: ходе
учитель: учителя
фактический: фактическую
дидактичекую: дидактичекую
легализовать: легализует
педофилия: педофилию
призывать: призывает
декриминализация: декриминализации
поведение: поведения
отмена: отмене
преступление: преступлением
бороться: бороться
тигист: тигист
эфиопия: эфиопии
изнасиловать: изнасилована
дом: доме
горничная: горничной
уволить: уволили
выжить: выжить
младенец: младенца
заняться: занялась
проституция: проституцией
прийти: пришла
нпо: нпо
итог: итоге
наставница: наставницей
занятие: занятие
замбия: замбии замбия
иначе: иначе
присущий: присуща
всеять: всей
процесс: процесс
длиться: длится
актуальный: актуален
эмоция: эмоциях
семейный: семейной
основной: основных
подвергнуться: подвергнутся
жестокий: жестокому
обращение: обращению
видеть: видела
беременеть: беременели
заражаться: заражались
хотеть: хочу
один: одной
лидий: лидия
ученица: ученица
лусака: лусаке
одноклассник: одноклассники
особенно: особенно
препятствие: препятствиями
область: области
поставщик: поставщиков
медицинский: медицинских
необходимый: необходимую
рада: рада
научить: научили
подписываться: подписывайтесь
рассылка: рассылку
загружать: загружайте
устройство: устройств
юнеско: юнеско
напоминать: напоминают
плюс: плюсах
пандемия: пандемии
детская: детской
смертность: смертности
увеличиться: увеличиться
сотня: сотни
воз: воз
намерен: намерены
вропейского: вропейского
жестокость: жестокости
ресурс: ресурсы
новостной: новостные
анонс: анонсы
журнал: журнал
отчет: отчеты
заседание: заседаниях
аудиовизуальный: аудиовизуальные
общение: общение
твиттер: твиттер
главное: главные
брифинг: брифингов
стенограмма: стенограммы
комментарий: комментарии
журналист: журналистов
фейсбук: фейсбук
вконтакте: вконтакте
контакт: контакты
сайт: сайтом
указатель: указатель
задавать: задаваемые
остерегаться: остерегайтесь
мошенничество: мошенничества
конфиденциальность: конфиденциальность
пользование: пользования
пожертвование: пожертвования