юнфпа: юнфпа
развенчивать: развенчивает
миф: мифы миф
менопауза: менопаузе менопауза менопаузы менопаузу менопаузой
призывать: призывает призывают
бороться: бороться
стигматизация: стигматизацией стигматизация стигматизацию
новость: новости
оон: оон
перейти: перейти
основное: основному
добро: добро
пожаловать: пожаловать
русский: русский
другой: другие другим
глобальный: глобальный
взгляд: взгляд
человеческий: человеческие
судьба: судьбы
поиск: поиск поиска
расширить: расширенный
язык: язык языке
меню: меню
главный: главная
азия: азия
америка: америка
африка: африка
ближний: ближний
восток: восток
европа: европа
тема: темы тему теме
гуманитарный: гуманитарная
помощь: помощь
беженец: беженцы
мигрант: мигранты
женщина: женщины женщин женщина женщинам
здравоохранение: здравоохранение
климат: климат
окружать: окружающая
среда: среда среды
культура: культура культурах
образование: образование
международный: международное
правый: право права прав
мир: мир мире
безопасность: безопасность
генеральный: генеральный генерального
секретарить: секретарь секретаря
человек: человека люди людей людьми
цель: цели
устойчивый: устойчивого
развитие: развития развитие
экономический: экономическое
подробный: подробнее
интервью: интервью
сюжет: сюжеты
экспресс-новости: экспресс-новости
фоторепортаж: фоторепортажи
пресс-секретарь: пресс-секретарь
выступление: выступления
заявление: заявления
пресса: прессой
официальный: официальные
поездка: поездки
фотография: фотографии
пресс-релиз: пресс-релизы
группа: группа
аккредитация: аккредитации
сми: сми
интернет-трансляция: интернет-трансляция
аудиотека: аудиотека
подписаться: подписаться
беннет: беннет
несмотря: несмотря
сопрячь: сопряжена
проблема: проблемами проблемы
многие: многих многие
также: также
знаменовать: знаменует
себя: собой
новый: новый новым новые нового новых
позитивный: позитивный позитивному
этап: этап этапы этапа этапе
жизнь: жизни жизнь
печать: печать
октябрь: октября
мэрилин: мэрилин
тридцать: тридцати
родственница: родственница
старший: старшего старше
возраст: возраста возраст возрасте
впервые: впервые
затронуть: затронула
арабский: арабском
часто: часто
называть: называют
эпоха: эпохой
отчаяние: отчаяния
преддверие: преддверии
всемирный: всемирного
день: дня
который: который которыми которых которые которое которой
ежегодно: ежегодно
отмечать: отмечают
фонд: фонд
область: области
народонаселение: народонаселения
напоминать: напоминает
трудность: трудностях
сталкиваться: сталкиваются
переживать: переживающие переживают
двоюродный: двоюродная
сестра: сестра
сказать: сказала
вступить: вступишь
закончиться: закончится
твой: твои
движение: движения
замедлиться: замедлятся
полностью: полностью
поменяться: поменяется
поделиться: поделилась
-летняя: -летняя
рамка: рамках
кампания: кампании
дестигматизации: дестигматизации
проект: проект
поддерживать: поддерживает поддерживать
агентство: агентство
сексуальный: сексуальному сексуальная сексуального
репродуктивный: репродуктивному репродуктивный репродуктивного
здоровье: здоровью здоровья здоровьем
почувствовать: почувствовала
говорить: говорит
собеседница: собеседница
чувствовать: чувствую чувствовать чувствуют
очень: очень
энергичный: энергичной
каждый: каждым
днем: днем
ощущать: ощущаю
расти: растущее расти
желание: желание
творить: творить
поставить: поставила
по-прежнему: по-прежнему
намерен: намерена
достигнуть: достичь
естественный: естественный естественную
процесс: процесс процессом
изменение: изменений изменениями изменение изменения
окончание: окончание окончанием
менструация: менструаций менструация
долгий: долгое
время: время временем
наложить: наложено
табу: табу
окутать: окутана
тайный: тайной
подобный: подобная подобный
привести: привела
тот: тому
миллион: миллионы
все: всем
мочь: могут можем
справиться: справиться
биологический: биологическими биологических
социальный: социальными социальное социальный
эмоциональный: эмоциональными эмоциональное эмоционального эмоциональные
психологический: психологическими психологическое
последствие: последствиями
переход: перехода переход
решить: решили
пролить: пролить
света: свет
часть: часть
развенчать: развенчать
подпитывать: подпитывают
страх: страх
непонимание: непонимание
лишь: лишь
некоторые: некоторые некоторых
задавать: задаваемых задаваемые
вопрос: вопросов вопросы
лечить: лечить
нужно: нужно
тяжелый: тяжелые
симптом: симптомы симптомами симптомов
справляться: справляются
свое: своими своего своих
домашние: домашних
условие: условиях условия
консультация: консультация
врач: врачом
важный: важна важное
убедиться: убедиться
иметь: имеют иметь
необходимый: необходимое необходимую
менее: менее
болезненный: болезненно
пережить: пережить
переходный: переходный
период: период периода
общий: общие
такой: такие такое
прилив: приливы
ночной: ночная
потливость: потливость
связанный: связаны связанные связанных связанную
ухудшение: ухудшением
память: памяти
структура: структуре
функция: функциях
связь: связях связи
мозг: мозга
бывать: бывает
трансгендерные: трансгендерные
мужчина: мужчины мужчин
гендерно: гендерно
разнообразный: разнообразные разнообразных
нуждаться: нуждаются
особый: особой
поддержка: поддержке поддержки поддержку поддержка
существовать: существует
острый: острая
потребность: потребность потребности потребностей
больший: большем большей
количество: количестве
дать: данных дать
медик: медики
понимать: понимали
конкретный: конкретные
лицо: лиц
гендерный: гендерными
различие: различиями
старение: старения старению
постменопаузе: постменопаузе
ценность: ценности ценность
общество: общества обществе
идея: идея
терять: теряют
заканчиваться: заканчивается
корениться: коренится
женоненавистничество: женоненавистничестве
соответствовать: соответствует
действительность: действительности
постменопаузальные: постменопаузальные
год: годы лет
ценный: ценны
способный: способны
вносить: вносить
вклад: вклад
благополучие: благополучие благополучию
семья: семьи
участвовать: участвовать участвуют
общественный: общественной
осваивать: осваивать
навык: навыки
помогать: помогать помогают помогает
развиваться: развиваться
влиять: влияет влияют
статус: статус
помимо: помимо
эффект: эффектов эффекты
оказывать: оказывает
глубокий: глубокое
воздействие: воздействие воздействия
повлиять: повлиять
опыт: опыт
значительный: значительной
степень: степени
социокультурный: социокультурные
фактор: факторы
раса: раса
этнический: этническая
принадлежность: принадлежность
класс: класс
ориентация: ориентация
исследование: исследования
показывать: показывают
качество: качество
менопаузального: менопаузального
зависеть: зависит
физический: физического физическое физические
пременопаузе: пременопаузе
отношение: отношения отношению
находиться: находится
женский: женскому
выход: выход выходом
рост: роста
независимо: независимо
различье: различий
переживаться: переживается
менопаузальный: менопаузальный
переоценка: переоценки
образ: образу
пересмотр: пересмотра
жизненный: жизненных жизненном
целый: целей
рассматриваться: рассматривается
праздноваться: празднуется
ритуал: ритуала
плодородие: плодородия
община: общинах
коренной: коренных
народ: народов
церемония: церемониях
получить: получить
исцеление: исцеление
руководство: руководство
празднование: празднование
давать: дает
свобода: свободу
сильный: сильными
сигнализировать: сигнализировать
финансовый: финансовой
независимость: независимости
расширение: расширении
возможность: возможностей
высокий: высоком
уровень: уровне уровень
забота: заботы
уверенность: уверенности
сила: силах
признать: признаем
полноценный: полноценными
член: членами
рассматривать: рассматриваем
деторождение: деторождение
единственный: единственное
предназначение: предназначение
гарантировать: гарантировать гарантирует
пожилой: пожилые пожилых
быть: будут
цениться: цениться
заслуживать: заслуживающими
избежать: избежать
обратить: обратить
вспять: вспять
функционировать: функционирующими
яичник: яичниками
удаться: удастся
побочный: побочные
контролировать: контролировать
доступ: доступ
качественный: качественным качественный
медицинский: медицинским медицинские медицинских
услуга: услугам услуг
протяжение: протяжении
всеять: всей
свой: своей
планировать: планировать
здоровый: здоровому здоровый
питание: питанию питание
понимание: пониманию
организм: организма
это: это
облегчить: облегчить
смягчить: смягчить
каков: каковы
положительный: положительные
облегчение: облегчение
прекращение: прекращением
необходимость: необходимости
контрацепция: контрацепции
знаменоваться: знаменуется
пенсия: пенсию
снижение: снижением
нагрузка: нагрузки
работа: работе
ребенок: дети
жить: живут
самостоятельно: самостоятельно
стать: стать
обновление: обновления
перенаправить: перенаправить
энергия: энергию
личной: личные личной
интерес: интересы
использовать: используют
личностный: личностного
увлечение: увлечений
карьерный: карьерных
путь: путей
подход: подход
основать: основанный
цикля: цикле
способствовать: способствует
андропауза: андропауза
мужской: мужская
термин: термин
использоваться: используется
обозначение: обозначения
возрастной: возрастных
гормональный: гормональных гормональные
происходить: происходят
включать: включать
потеря: потерю
половой: полового
влечение: влечения
эректильную: эректильную
дисфункция: дисфункцию
психический: психическим
вводить: вводить
заблуждение: заблуждение
предполагать: предполагает
возникать: возникают
результат: результате
внезапный: внезапного
падение: падения падению
тестостерон: тестостерона тестостероном
средний: среднем
аналогичный: аналогично
эстроген: эстрогена
испытывать: испытывают
действительно: действительно
править: правило
течение: течение
длительный: длительного
временить: времени
число: числе
должен: должны
регулярно: регулярно
проходить: проходить
осмотр: осмотры
регулярный: регулярные
упражнение: упражнения
сон: сон
сбалансированный: сбалансированное
случай: случаях
заместительный: заместительная
терапия: терапия
улучшить: улучшить
передний: переднем
край: крае
борьба: борьбы
интеграция: интеграцию
широкий: широкие
программа: программы
снизить: снизить
разрабатывать: разрабатывает
образовательный: образовательные
ресурс: ресурсы
продвигать: продвигает
мера: меры
внедрение: внедрению
рабочий: рабочих
место: местах
политик: политики
направить: направленной
прежде: прежде
работать: работает
нарушить: нарушить
молчание: молчание
получать: получали
продолжать: продолжали
голос: голоса
подписываться: подписывайтесь
наш: нашу наши
рассылка: рассылку
загружать: загружайте
приложение: приложение
мобильный: мобильных
устройство: устройств
медицина: медицина
индустрия: индустрия
красота: красоты
рынок: рынок
средство: средств
гигиена: гигиены
защитить: защищены
токсичный: токсичных
вещество: веществ
воз: воз
пройти: прошел
преквалификацию: преквалификацию
первый: первый
биоаналог: биоаналог
препарат: препарата
лечение: лечения
рак: рака
грудь: груди
списывать: списывать
счеты: счетов
информация: информация
партнер: партнеров
новостной: новостные
анонс: анонсы
журнал: журнал
отчет: отчеты
заседание: заседаниях
аудиовизуальный: аудиовизуальные
материал: материалы
общение: общение
твиттер: твиттер
последний: последние
главное: главные
брифинг: брифингов
стенограмма: стенограммы
комментарий: комментарии
журналист: журналистов
интернет: интернете
фейсбук: фейсбук
вконтакте: вконтакте
контакт: контакты
пользоваться: пользоваться
сайт: сайтом
указатель: указатель
остерегаться: остерегайтесь
мошенничество: мошенничества
конфиденциальность: конфиденциальность
пользование: пользования
пожертвование: пожертвования