воз: воз
составить: составили составлены
список: список списка
патоген: патогенов патогены патогену
который: которых которые которыми
срочный: срочно
необходимый: необходимы
новый: новые новом новых новый
вакцина: вакцины вакцин вакцинах вакцинам вакцина
новость: новости
оон: оон
перейти: перейти
основное: основному
добро: добро
пожаловать: пожаловать
русский: русский
другой: другие
глобальный: глобальный глобальные
взгляд: взгляд
человеческий: человеческие
судьба: судьбы
поиск: поиск
расширить: расширенный
язык: язык
меню: меню
главный: главная
азия: азия
америка: америка
африка: африка
ближний: ближний
восток: восток
европа: европа
тема: темы теме
гуманитарный: гуманитарная
помощь: помощь
беженец: беженцы
мигрант: мигранты
женщина: женщины
здравоохранение: здравоохранение здравоохранения
климат: климат
окружать: окружающая
среда: среда
культура: культура
образование: образование
международный: международное международным
правый: право права
мир: мир
безопасность: безопасность
генеральный: генеральный генерального
секретарить: секретарь секретаря
человек: человека человек
цель: цели
устойчивый: устойчивого устойчивыми
развитие: развития развитие
экономический: экономическое
подробный: подробнее
интервью: интервью
сюжет: сюжеты
экспресс-новости: экспресс-новости
фоторепортаж: фоторепортажи
пресс-секретарь: пресс-секретарь
выступление: выступления
заявление: заявления
пресса: прессой
официальный: официальные
поездка: поездки
фотография: фотографии
пресс-релиз: пресс-релизы
группа: группа группы
аккредитация: аккредитации
сми: сми
интернет-трансляция: интернет-трансляция
аудиотека: аудиотека
подписаться: подписаться
фото: фото
оонф: оонф
иса: иса
обратиться: обратилась
региональный: региональным региональное региональный региональными региональные
эксперт: экспертам
просьба: просьбой
определить: определить определены
фактор: факторы фактором
иметь: имеют
большой: наибольшее
значение: значение
принятие: принятии
решение: решения
какой: какие
следовать: следует
внедрять: внедрять
использовать: использовать
печать: печать
ноябрь: ноября
исследование: исследовании исследование исследований
всемирный: всемирной
организация: организации
опубликовать: опубликованном
сегодня: сегодня
журнал: журнале журнал
названый: названы
регулярно: регулярно
вызывать: вызывают
заболевание: заболевания заболеваний
сообщество: сообществах сообщества
нужный: нужны
приоритетный: приоритетные приоритетных приоритетный
направление: направления
работа: работы
это: это
первое: первое
подобный: подобного
род: рода
ученый: ученые
составление: составлении
учитывать: учитывали
бремя: бремя
болезный: болезней
риск: риск
устойчивость: устойчивости
противомикробный: противомикробным
препарат: препаратам
социально-экономический: социально-экономические
последствие: последствия
возможный: возможных
вспышка: вспышек
подтверждать: подтверждает
давний: давние
приоритет: приоритеты приоритетов
разработка: разработок разработки
число: числе
вич: вич
малярия: малярии малярия
туберкулез: туберкулеза
три: трех
совокупность: совокупности
уносить: уносят
миллион: миллиона
жизнь: жизней
каждый: каждый каждому каждого
год: год года
также: также
такой: такие
стрептококк: стрептококк
качество: качестве
главное: главных главным главные
борьба: борьбе борьбы
болезнь: болезнями
регион: регионах региона
подчеркивать: подчеркивает
срочность: срочность
становиться: становятся
прибыль: прибыль
должен: должна
слишком: слишком
часто: часто
определяться: определялись
исключительно: исключительно
отдача: отдачей
инвестиция: инвестиций
количество: количеством
спасти: спасти
наиболее: наиболее
уязвимый: уязвимых
заявить: заявила
кейт: кейт
обрайен: обрайен
директор: директор
департамент: департамента
иммунизация: иммунизации
биологический: биологическим
использоваться: используется
обширный: обширный
опыт: опыт
дать: данные данными
оценка: оценки
значительно: значительно
снизить: снизят
уровень: уровень
заболеваемость: заболеваемости
сильный: сильно
влиять: влияющей
сегодняшний: сегодняшние
медицинский: медицинские
расход: расходы
сталкиваться: сталкиваются
семья: семьи
система: системы
результат: результате
анализ: анализа
этот: этих
предпочтенье: предпочтений
сочетание: сочетании
затем: затем
перечень: перечни
объединить: объединены
выделить: выделены
эндемичный: эндемичных
необходимо: необходимо
исследовать: исследовать
разработать: разработать
область: области
способствовать: способствует
достижение: достижению
повестка: повестки
день: дня
период: период
заключаться: заключающейся
обеспечение: обеспечении
мочь: мог
получить: получить
польза: пользу
защищать: защищающих
серьезный: серьезных
вирус: вирус
гепатит: гепатита
вич-: вич-
клебсиелла: клебсиелла
пневмония: пневмония
цитомегаловирус: цитомегаловирус
грипп: гриппа
широкий: широко
защитный: защитная
вид: виды
нетифоидная: нетифоидная
сальмонелла: сальмонелла
норовирус: норовирус
шигеллы: шигеллы
золотистый: золотистый
стафилококк: стафилококк
денге: денге
внекишечный: внекишечная
патогенный: патогенная
кишечный: кишечная
палочка: палочка
микобактерии: микобактерии
респираторно-синцитиальный: респираторно-синцитиальный
рсв: рсв
подписываться: подписывайтесь
наш: нашу наши
рассылка: рассылку
загружать: загружайте
приложение: приложение
мобильный: мобильных
устройство: устройств
фейсбук: фейсбук
инстаграм: инстаграм
помочь: помогут
распространять: распространять
достоверный: достоверную
информация: информацию информация
начать: начали
испытание: испытание
коронавирус: коронавируса
глава: глава
смертность: смертность
снова: снова
расти: растет
ресурс: ресурсы
партнер: партнеров
новостной: новостные
анонс: анонсы
отчет: отчеты
заседание: заседаниях
аудиовизуальный: аудиовизуальные
материал: материалы
общение: общение
твиттер: твиттер
последний: последние
брифинг: брифингов
стенограмма: стенограммы
комментарий: комментарии
журналист: журналистов
интернет: интернете
вконтакте: вконтакте
контакт: контакты
пользоваться: пользоваться
сайт: сайтом
указатель: указатель
задавать: задаваемые
вопрос: вопросы
остерегаться: остерегайтесь
мошенничество: мошенничества
конфиденциальность: конфиденциальность
условие: условия
пользование: пользования
пожертвование: пожертвования