ливан: ливан ливане ливана
воз: воз
предупреждать: предупреждает предупреждают
риск: рисках
распространение: распространения
холера: холеры холерой холера холере
условие: условиях условия
массовый: массовой
эвакуация: эвакуации
новость: новости
оон: оон
перейти: перейти
основное: основному
добро: добро
пожаловать: пожаловать
русский: русский
другой: другие
глобальный: глобальный
взгляд: взгляд
человеческий: человеческие
судьба: судьбы
поиск: поиск
расширить: расширенный
язык: язык
меню: меню
главный: главная
азия: азия
америка: америка
африка: африка
ближний: ближний
восток: восток
европа: европа
тема: темы теме
гуманитарный: гуманитарная гуманитарной
помощь: помощь помощи помощью
беженец: беженцы
мигрант: мигранты
женщина: женщины
здравоохранение: здравоохранение здравоохранения
климат: климат
окружать: окружающая
среда: среда среду
культура: культура
образование: образование
международный: международное
правый: право права
мир: мир
безопасность: безопасность безопасности
генеральный: генеральный генерального
секретарить: секретарь секретаря
человек: человека человек
цель: цели
устойчивый: устойчивого
развитие: развития развитие
экономический: экономическое
подробный: подробнее
интервью: интервью
сюжет: сюжеты
экспресс-новости: экспресс-новости
фоторепортаж: фоторепортажи
пресс-секретарь: пресс-секретарь
выступление: выступления
заявление: заявления заявлении
пресса: прессой
официальный: официальные
поездка: поездки
фотография: фотографии
пресс-релиз: пресс-релизы
группа: группа
аккредитация: аккредитации
сми: сми
интернет-трансляция: интернет-трансляция
аудиотека: аудиотека
подписаться: подписаться
распределение: распределение
медицинский: медицинских медицинскими медицинские
материал: материалов материалы материалами
печать: печать
октябрь: октября
первый: первый первой
случай: случай
заболевание: заболевания заболевание
зафиксировать: зафиксирован зафиксировала
север: севере
вызывать: вызывает
опасение: опасения
угроза: угрозах угрозами
здоровье: здоровью
жизнь: жизни
вынудить: вынужденных вынуждены
переселенец: переселенцев
заявить: заявили
сегодня: сегодня
всемирный: всемирной
организация: организации организация
подтвердить: подтвержден подтвержденных
аккаре: аккаре
сам: самой
северный: северной северную
провинция: провинции
страна: страны
директор: директор
тедрос: тедрос
адханом: адханом
гебрейесус: гебрейесус
объявить: объявил
запуск: запуске
план: плана
реагирование: реагирования
усиление: усиления
эпиднадзор: эпиднадзора
отслеживание: отслеживания
контакт: контактов контакты
забор: забора
проба: проб
воды: воды
отсутствие: отсутствие отсутствии отсутствия
иммунитет: иммунитета иммунитет
отметить: отметил
август: августе
ливанский: ливанские ливанских
орган: органы
начать: начали
кампания: кампанию кампании
вакцинация: вакцинации вакцинация
тысяча: тысяч
однако: однако
усилие: усилия
прервать: прерваны
эскалация: эскалации
перестрелка: перестрелок
хезболлой: хезболлой
израильский: израильскими
военный: военными военных
расширение: расширения
действие: действий
израиль: израиля
прошлый: прошлом прошлую
месяц: месяце месяц
исполнять: исполняющий
обязанность: обязанности
представитель: представителя
абдинасир: абдинасир
абубакар: абубакар абубакара
очередь: очередь
выразить: выразил
обеспокоенность: обеспокоенность
угрожать: угрожает
многие: многим
тот: тех
бежать: бежал
насилие: насилия
юг: юге
дать: данным данный
власть: властей
момент: момент моменте
миллион: миллиона
покинуть: покинуть
свое: свои
дома: дома
читать: читайте
также: также
катастрофический: катастрофической
ситуация: ситуации
переломный: переломном
сирия: сирии
слово: словам
очень: очень
быстро: быстро
распространяться: распространяться распространяется
население: населения
бейрут: бейруте
течение: течение
последний: последних последние
год: лет
сложиться: сложился
низкий: низкий
это: это
плохой: плохих
санитарный: санитарных
доступ: доступа
чистый: чистой
вод: воде
система: система
глава: глава
сообщить: сообщил
распределить: распределила
больница: больницам больниц больницы
раненый: раненым
сотрудничество: сотрудничестве
красный: красным
крест: крестом
учреждение: учреждениями учреждения учреждений
начало: начала
оснащение: оснащение
банк: банков
кровь: крови
безопасный: безопасного
донорство: донорства
обучение: обучение
хирург: хирургов
спасение: спасению
конечность: конечностей
ампутация: ампутации
тедроса: тедроса
решение: решения
проблема: проблемы
необходимый: необходима
боев: боевых
назад: назад
нападение: нападения
результат: результате
который: которых
погибнуть: погибли
получить: получили
ранение: ранения
укгв: укгв
грузовик: грузовики
направляться: направляются
удаленный: удаленные
деревня: деревни
больший: большее
число: число
особенно: особенно
закрываться: закрываться
интенсивный: интенсивных
бомбардировка: бомбардировок
сказать: сказал
добавить: добавив
половина: половина половине
центр: центров
первичный: первичной
медико-санитарный: медико-санитарной
район: районах районе
затронуть: затронутых
конфликт: конфликтом
перестать: перестала
работать: работать
полностью: полностью
частично: частично
эвакуировать: эвакуированы
испытывать: испытывают
огромный: огромную
нагрузка: нагрузку
иметь: имеют
деть: дело
беспрецедентный: беспрецедентным
приток: притоком
травма: травм
пытаться: пытаются
поддерживать: поддерживать
основной: основные
услуга: услуги
подчеркнуть: подчеркнул подчеркнули
полиомиелит: полиомиелита
газ: газе газы газа
время: временем
проходить: проходит
второй: второй
раунд: раунд
успех: успех
зависеть: зависит
возможность: возможности
привить: привить
крайний: крайней
мера: мере
процент: процентов
ребенок: детей
возраст: возрасте
анклав: анклава
один: одна одной
запланировать: запланированных
миссия: миссий миссии
часть: часть
успешный: успешно
организовать: организована
девять: девяти
попытка: попыток
партнер: партнеры партнеров
смочь: смогли
доставить: доставить
топливо: топливо
камаль-адван: камаль-адван
аль-сахаба: аль-сахаба
суббота: субботу
пояснить: пояснил
вновь: вновь
осудить: осудил
продолжаться: продолжающиеся
всеять: всей
обстрел: обстрел
позиция: позиций позиции позициям
всоонл: всоонл
временной: временных
сила: сил
утро: утром
местный: местному
временить: времени
танк: танк
цахал: цахал
меркава: меркава
открыть: открыл
огонь: огонь
сторожевой: сторожевой
вышка: вышке
миротворец: миротворцев
кфар-кила: кфар-кила
два: две
камера: камеры
уничтожить: уничтожены
объект: объект
повредить: поврежден
очередной: очередной
наблюдать: наблюдаем
прямая: прямой
по-видимому: по-видимому
преднамеренный: преднамеренный
говориться: говорится
напоминать: напоминаем
все: всем
заинтересовать: заинтересованным
сторона: сторонам
обязательство: обязательствах
обеспечение: обеспечению
защита: защиты
персонал: персонала
имущество: имущества
необходимость: необходимости
уважать: уважать
неприкосновенность: неприкосновенность
помещение: помещений
подписываться: подписывайтесь
наш: нашу наши
рассылка: рассылку
загружать: загружайте
приложение: приложение
мобильный: мобильных
устройство: устройств
медик: медики
сталкиваться: сталкиваются
серьезный: серьезными
ход: ходе
свой: своей
работа: работы
сириец: сирийцы
массово: массово
покидать: покидают
фон: фоне
возвращаться: возвращаются
генсек: генсек
должен: должен
стать: стать
газа: газой
ресурс: ресурсы
информация: информация
новостной: новостные
анонс: анонсы
журнал: журнал
отчет: отчеты
заседание: заседаниях
аудиовизуальный: аудиовизуальные
общение: общение
твиттер: твиттер
главное: главные
брифинг: брифингов
стенограмма: стенограммы
комментарий: комментарии
журналист: журналистов
интернет: интернете
фейсбук: фейсбук
вконтакте: вконтакте
пользоваться: пользоваться
сайт: сайтом
указатель: указатель
часто: часто
задавать: задаваемые
вопрос: вопросы
остерегаться: остерегайтесь
мошенничество: мошенничества
конфиденциальность: конфиденциальность
пользование: пользования
пожертвование: пожертвования