новый: новые новое
рекомендация: рекомендации
воз: воз
геймер: геймеров геймеры
играть: играть играют
видеоигра: видеоигры видеоигр
потерять: потерять
слух: слух слуха
новость: новости
оон: оон
перейти: перейти
основное: основному
добро: добро
пожаловать: пожаловать
русский: русский
другой: другие
глобальный: глобальный глобальное
взгляд: взгляд
человеческий: человеческие
судьба: судьбы
поиск: поиск
расширить: расширенный
язык: язык
меню: меню
главный: главная
азия: азия
америка: америка
африка: африка
ближний: ближний
восток: восток
европа: европа
тема: темы теме
гуманитарный: гуманитарная
помощь: помощь помощи
беженец: беженцы
мигрант: мигранты
женщина: женщины
здравоохранение: здравоохранение здравоохранения
климат: климат
окружать: окружающая
среда: среда
культура: культура
образование: образование
международный: международное международный
правый: право права
мир: мир мире
безопасность: безопасность безопасности
генеральный: генеральный генерального
секретарить: секретарь секретаря
человек: человека человек
цель: цели
устойчивый: устойчивого
развитие: развития развитие
экономический: экономическое
подробный: подробнее
интервью: интервью
сюжет: сюжеты
экспресс-новости: экспресс-новости
фоторепортаж: фоторепортажи
пресс-секретарь: пресс-секретарь
выступление: выступления
заявление: заявления
пресса: прессой
официальный: официальные
поездка: поездки
фотография: фотографии
пресс-релиз: пресс-релизы
группа: группа
аккредитация: аккредитации
сми: сми
интернет-трансляция: интернет-трансляция
аудиотека: аудиотека
подписаться: подписаться
длительный: длительного
воздействие: воздействия
звуковой: звукового
сопровождение: сопровождения
высокий: высокой
громкость: громкости громкость
подвергаться: подвергаются
риск: риску риске
потеря: потери потеря
печать: печать
февраль: февраля
три: трех
миллиард: миллиардов
компьютер: компьютерах компьютеров
игровой: игровых
приставка: приставках
мобильный: мобильных мобильное
телефон: телефонах телефонов
однако: однако
большинство: большинство
устройство: устройств
игра: игр играм
иметь: имеют
функция: функций функции
безопасный: безопасного безопасным
прослушивание: прослушивания
преддверие: преддверии
всемирный: всемирного всемирная
день: дня
который: который которые
отмечаться: отмечается
марта: марта
организация: организация
союз: союз
электросвязь: электросвязи
мсэ: мсэ
выпустить: выпустили
первое: первое
руководство: руководство
направить: направленное
предотвращение: предотвращение предотвращения
сегодня: сегодня
каждый: каждый
принять: принять
мера: меры мерах
поддержка: поддержки
хороший: хорошего
протяжение: протяжении
всеять: всей
свой: своей
жизнь: жизни
сказать: сказал
жером: жером
саломон: саломон
помощник: помощник
директор: директора директор
инфекционный: инфекционным
неинфекционный: неинфекционным
заболевание: заболеваниям
киберспорт: киберспорт
быстро: быстро
становиться: становятся
один: одним одна
крупный: крупнейших
сектор: секторов сектору
индустрия: индустрии индустрия
развлеченье: развлечений
все: всем
ребенок: дети детей
особенно: особенно
уязвимый: уязвимы уязвимых
интерес: интерес
стремительно: стремительно
расти: растет расти
худой: хуже
переносить: переносят
громкий: громкие
звук: звуки звука звук
призвать: призваны
информировать: информировать
также: также
помочь: помочь
правительство: правительствам
частное: частному
представитель: представителям
гражданский: гражданского
общество: общества
разработать: разработать
соответствующий: соответствующие
стандарт: стандарты
киберспорта: киберспорта
продолжать: продолжает
использовать: используют
широкий: широкий
спектр: спектр
доступ: доступа
контент: контенту
очень: очень
важный: важны
защита: защиты
пользователь: пользователей пользователя пользователям
сейдзо: сейдзо
оноэ: оноэ
бюро: бюро
стандартизация: стандартизации
содержать: содержит
отдельный: отдельные
консоль: консолей
наушник: наушников наушниками
гарнитур: гарнитуры
программный: программного
обеспечение: обеспечения
отслеживание: отслеживание
допустимый: допустимого
уровень: уровня
встраивание: встраивание
оповещение: оповещений
предоставлять: предоставляют
игрок: игрокам игрок
необходимый: необходимую
информация: информацию информация
включать: включая
прогноз: прогнозы
достигнуть: достигнут
предел: предел
введение: введение
удобный: удобной
система: системы
регулировка: регулировки
режим: режима
автоматически: автоматически
регулировать: регулирует
переключаться: переключается
колонка: колонками
читать: читайте
приглушить: приглушите
современный: современном
чаща: чаще
грозить: грозит
молодая: молодым
подписываться: подписывайтесь
наш: нашу наши
рассылка: рассылку
загружать: загружайте
приложение: приложение
позволить: позволит
проверить: проверить
глава: глава
сокращение: сокращение
сша: сша
сделать: сделает
менее: менее
здоровый: здоровым
процветать: процветающим
транспортировка: транспортировка
радиоактивный: радиоактивных
материал: материалов материалы
наиболее: наиболее
сфера: сфер
ядерный: ядерной
ресурс: ресурсы
партнер: партнеров
новостной: новостные
анонс: анонсы
журнал: журнал
отчет: отчеты
заседание: заседаниях
аудиовизуальный: аудиовизуальные
общение: общение
твиттер: твиттер
последний: последние
главное: главные
брифинг: брифингов
стенограмма: стенограммы
комментарий: комментарии
журналист: журналистов
интернет: интернете
фейсбук: фейсбук
вконтакте: вконтакте
контакт: контакты
пользоваться: пользоваться
сайт: сайтом
указатель: указатель
часто: часто
задавать: задаваемые
вопрос: вопросы
остерегаться: остерегайтесь
мошенничество: мошенничества
конфиденциальность: конфиденциальность
условие: условия
пользование: пользования
пожертвование: пожертвования