воз: воз
риск: риск
заражение: заражения заражение
птичий: птичьим птичий
грипп: гриппом грипп
оставаться: остается
низкий: низким низкий ниже
несмотря: несмотря
первый: первый
смертельный: смертельный
случай: случай случае
сша: сша
новость: новости
оон: оон
перейти: перейти
основное: основному
добро: добро
пожаловать: пожаловать
русский: русский
другой: другие
глобальный: глобальный
взгляд: взгляд
человеческий: человеческие
судьба: судьбы
поиск: поиск
расширить: расширенный
язык: язык
меню: меню
главный: главная
азия: азия
америка: америка
африка: африка
ближний: ближний
восток: восток
европа: европа
тема: темы теме
гуманитарный: гуманитарная
помощь: помощь
беженец: беженцы
мигрант: мигранты
женщина: женщины
здравоохранение: здравоохранение здравоохранения
климат: климат
окружать: окружающая
среда: среда
культура: культура
образование: образование
международный: международное
правый: право права
мир: мир
безопасность: безопасность
генеральный: генеральный генерального
секретарить: секретарь секретаря
человек: человека людей людьми человек
цель: цели
устойчивый: устойчивого устойчивой
развитие: развития развитие
экономический: экономическое
подробный: подробнее
интервью: интервью
сюжет: сюжеты
экспресс-новости: экспресс-новости
фоторепортаж: фоторепортажи
пресс-секретарь: пресс-секретарь
выступление: выступления
заявление: заявления
пресса: прессой
официальный: официальные
поездка: поездки
фотография: фотографии
пресс-релиз: пресс-релизы
группа: группа
аккредитация: аккредитации
сми: сми
интернет-трансляция: интернет-трансляция
аудиотека: аудиотека
подписаться: подписаться
фаос: фаос
камбу: камбу
вирус: вирус вируса
распространяться: распространяется
происходить: происходит
контакт: контакте контакты
домашний: домашней
птица: птицей птицами
скот: скотом
печать: печать
январь: января
сообщение: сообщения
первое: первом
летальный: летальном
инфицированный: инфицированного
всемирный: всемирной
организация: организации
подчеркнуть: подчеркнули подчеркнула
угроза: угроза угрозы
широкий: широкой
общественность: общественности
минимальный: минимальной
представительница: представительница
маргарета: маргарет
харрис: харрис
сообщить: сообщила
журналист: журналистам журналистов
женева: женеве
вторник: вторник
вызывать: вызывающий вызывает
заболевание: заболевание заболеваний заболевания заболеванием
наблюдать: наблюдаем
передача: передачи
инфекция: инфекции инфекция инфекций инфекциями
скончаться: скончавшийся
луизиане: луизиане
пациент: пациент пациентов
старший: старше
год: лет году года
иметься: имеющимся
дать: данным
страдать: страдал
хронический: хронических
также: также
находиться: находился находятся
непосредственный: непосредственном
домашние: домашними
дикий: дикими
уточнить: уточнила
ход: ходе
текущий: текущей
вспышка: вспышки
несколько: несколько
десяток: десятков
заразиться: заразились
преимущественный: преимущественно
это: это
фермер: фермеры
работать: работающие
читать: читайте
распространиться: распространился
страна: стран страны
территория: территорий
отметить: отметила
по-прежнему: по-прежнему
оценивать: оценивает
основной: основной
акцент: акцент
делаться: делается
защита: защиту
работник: работников
определить: определенных
отрасль: отраслей
добавить: добавила
продолжаться: продолжается
мониторинг: мониторинг
животное: животных
работа: работе
предприятие: предприятий
сельский: сельского
хозяйство: хозяйства
производство: производства
продукт: продуктов
питание: питания
метапневмовирус: метапневмовирус
китай: китае
сезонный: сезонное сезонным
повышение: повышение
заболеваемость: заболеваемости заболеваемость
внимание: внимание
привлечь: привлекло
распространение: распространение распространения
респираторный: респираторного респираторных респираторные респираторными
известный: известного
представлять: представляет
новый: новой
серьезный: серьезной
слово: словам
увеличение: увеличение
число: числа
такой: таких
соответствовать: соответствует
ожидание: ожиданиям
самый: самым
распространить: распространенным
центр: центра
контроль: контроля
профилактика: профилактики
масштаб: масштабы
информация: информации информация
местный: местных
орган: органов
предел: пределах
норма: нормы
зимний: зимнего
сезон: сезона
власть: власти
сообщать: сообщают
загруженность: загруженность
больница: больниц
аналогичный: аналогичный
период: период
прошлый: прошлого
никакой: никаких
чрезвычайный: чрезвычайных
мера: мер меры
ввести: введено
касаться: касается
метапневмовируса: метапневмовируса
впервые: впервые
выявить: выявлен
давно: давно
циркулировать: циркулирует
население: населения
объяснить: объяснила
обычно: обычно
симптом: симптомы
схожий: схожие
простуда: простудой
протекать: протекать
тяжелый: тяжело
ослабить: ослабленным
иммунитет: иммунитетом
младенец: младенцев
пожилой: пожилых
отвечать: отвечая
вопрос: вопрос вопросы
смертность: смертности
доктор: доктор
показатель: показатель
очень: очень
рекомендовать: рекомендовала
простой: простые
включать: включая
ношение: ношение
маска: масок
улучшение: улучшение
вентиляция: вентиляции
помещение: помещениях
регулярный: регулярное
мытье: мытье
рука: рук руки
подписываться: подписывайтесь
наш: нашу наши
рассылка: рассылку
загружать: загружайте
приложение: приложение
мобильный: мобильных
устройство: устройств
инфекционный: инфекционные инфекционных
мыть: мойте
призывать: призывают
врач: врачей
эксперт: эксперты
медучреждение: медучреждения
должен: должны
рассадник: рассадником
болезный: болезней
европейский: европейском
регион: регионе
расти: растет
ресурс: ресурсы
партнер: партнеров
новостной: новостные
анонс: анонсы
журнал: журнал
отчет: отчеты
заседание: заседаниях
аудиовизуальный: аудиовизуальные
материал: материалы
общение: общение
твиттер: твиттер
последний: последние
главное: главные
брифинг: брифингов
стенограмма: стенограммы
комментарий: комментарии
интернет: интернете
фейсбук: фейсбук
вконтакте: вконтакте
пользоваться: пользоваться
сайт: сайтом
указатель: указатель
часто: часто
задавать: задаваемые
остерегаться: остерегайтесь
мошенничество: мошенничества
конфиденциальность: конфиденциальность
условие: условия
пользование: пользования
пожертвование: пожертвования