оон: оон
призвать: призвали призвав
выделить: выделить
миллион: млн миллиона
доллар: долларов
подготовка: подготовку
всплеск: всплеску всплеска
заболеваемость: заболеваемости
оспа: оспой оспы оспу оспа
обезьяна: обезьян
новость: новости
перейти: перейти
основное: основному основном
добро: добро
пожаловать: пожаловать
русский: русский
другой: другие других
глобальный: глобальный глобального
взгляд: взгляд
человеческий: человеческие
судьба: судьбы
поиск: поиск
расширить: расширенный
язык: язык
меню: меню
главный: главная
азия: азия
америка: америка
африка: африка африке африки
ближний: ближний
восток: восток
европа: европа
тема: темы теме
гуманитарный: гуманитарная
помощь: помощь помощи помощью
беженец: беженцы
мигрант: мигранты мигрантов
женщина: женщины
здравоохранение: здравоохранение здравоохранения
климат: климат
окружать: окружающая
среда: среда среду
культура: культура
образование: образование
международный: международное международная международных
правый: право права
мир: мир мире
безопасность: безопасность
генеральный: генеральный генерального
секретарить: секретарь секретаря
человек: человека людей человеку людьми
цель: цели
устойчивый: устойчивого
развитие: развития развитие
экономический: экономическое
подробный: подробнее
интервью: интервью
сюжет: сюжеты
экспресс-новости: экспресс-новости
фоторепортаж: фоторепортажи
пресс-секретарь: пресс-секретарь
выступление: выступления
заявление: заявления
пресса: прессой
официальный: официальные
поездка: поездки
фотография: фотографии
пресс-релиз: пресс-релизы
группа: группа группы
аккредитация: аккредитации
сми: сми
интернет-трансляция: интернет-трансляция
аудиотека: аудиотека
подписаться: подписаться
фото: фото
юнисеф: юнисеф
эфиопиим: эфиопиим
айен: айен
мать: мать
ребенок: ребенок
лагер: лагере
переместить: перемещенных
лицо: лиц
эфиопия: эфиопии
печать: печать
август: августа
распространение: распространение распространением
восточный: восточной восточная
южный: южной южная южного
часть: частях часть
африканский: африканского африканском африканских
континент: континента
увеличить: увеличило
риск: риск риску
заражение: заражения заражению
который: которые которыми
нуждаться: нуждаются
критически: критически
важный: важной
медицинский: медицинской
поддержка: поддержке поддержку
преддверие: преддверии
ожидать: ожидаемого
случай: случаев случаи
заболевание: заболевания
сообщить: сообщила сообщивших
организация: организация организации
миграция: миграции
мом: мом
финансирование: финансирования
ответный: ответных ответные
мера: мер меры
дать: данным данные
также: также
население: населения
вынудить: вынужденные
покидать: покидать
свое: свои
дома: дома
результат: результате
чрезвычайный: чрезвычайных чрезвычайной
ситуация: ситуаций ситуацией
природный: природного
характер: характера
конфликт: конфликтов
горазд: гораздо
больший: большей
степень: степени
подверженный: подвержены
тяжелый: тяжелых
условие: условий условия
жизнь: жизни
барьер: барьеров
сталкиваться: сталкиваются
обращение: обращении
рог: роге рога
юг: юге
вызывать: вызывает
серьезный: серьезную
обеспокоенность: обеспокоенность
заявить: заявила
эми: эми
поуп: поуп
директор: директор
должен: должны
действовать: действовать
быстро: быстро
защитить: защитить
тот: тех
подвергаться: подвергается
большой: наибольшему
целый: целом
смягчить: смягчить
воздействие: воздействие
вспышка: вспышки вспышке
регион: регион регионах
миграционный: миграционный
хаб: хаб
принимать: принимают
половина: половину
всемирный: всемирной всемирная
воз: воз
начало: начало
шесть: шесть
страна: стран
находиться: находятся
этот: этих
новый: новые нового
зафиксировать: зафиксированы
ранее: ранее
затронуть: затронутых
вирус: вирусом
кения: кении
бурунди: бурунди
руанда: руанде руанды
уганда: уганде уганды
призыв: призыв
профинансировать: профинансировать
демократический: демократической
республика: республики
конго: конго
эсватини: эсватини
малави: малави
мозамбик: мозамбика
судан: судана
танзания: танзании
замбия: замбии
зимбабве: зимбабве
направить: направлен
профилактика: профилактике
контроль: контролю
реагирование: реагированию реагирования
инфекция: инфекции
особенно: особенно
пограничный: пограничных
переход: переходах
угроза: угроза
здоровье: здоровью
прошлый: прошлой
неделя: неделе
объявить: объявила
область: области
общественный: общественного
иметь: имеющей
значение: значение
такой: такое таких
решение: решение
принять: принято
связь: связи
быстрый: быстрым
штамм: штамма
известный: известного
клад: клада
эпицентр: эпицентром
нынешний: нынешней
являться: является
передаваться: передается
половой: половым
путем: путем
оговориться: оговорилась
вторник: вторник
необходимый: необходимы
дополнительный: дополнительные
исследование: исследования
потенциальный: потенциальных
способ: способов
постельный: постельное
белье: белье
пользоваться: пользовались пользоваться
инфицированный: инфицированные инфицированными
последний: последние
указывать: указывают
тысяча: тысяч
предполагать: предполагаемых
дрк: дрк
число: числе число
смерть: смертей
общий: общее
составлять: составляет
известно: известно
болезнь: болезнь болезнью
животное: животных животными
распространяться: распространяется
тесный: тесном
контакт: контакте контакты
воздушно-капельный: воздушно-капельным
кровь: кровь
биологический: биологические
жидкость: жидкости
симптом: симптомы
включать: включают
лихорадка: лихорадку
сыпать: сыпь
появление: появление
язва: язв
тело: теле
головной: головные
мышечный: мышечные
боль: боли боль
горло: горле
спина: спине
увеличение: увеличение
лимфатический: лимфатических
узел: узлов
подписываться: подписывайтесь
наш: нашу наши
рассылка: рассылку
загружать: загружайте
приложение: приложение
мобильный: мобильных
устройство: устройств
одобрить: одобрила
первый: первый
диагностический: диагностический
метод: метод
выявление: выявления
выпустить: выпустили
обновить: обновленные
рекомендация: рекомендации
опасение: опасения
повод: поводу
усилиться: усилились
стать: стала
север: севера
ресурс: ресурсы
информация: информация
партнер: партнеров
новостной: новостные
анонс: анонсы
журнал: журнал
отчет: отчеты
заседание: заседаниях
аудиовизуальный: аудиовизуальные
материал: материалы
общение: общение
твиттер: твиттер
главное: главные
брифинг: брифингов
стенограмма: стенограммы
комментарий: комментарии
журналист: журналистов
интернет: интернете
фейсбук: фейсбук
вконтакте: вконтакте
сайт: сайтом
указатель: указатель
часто: часто
задавать: задаваемые
вопрос: вопросы
остерегаться: остерегайтесь
мошенничество: мошенничества
конфиденциальность: конфиденциальность
пользование: пользования
пожертвование: пожертвования