медицина: медицина
индустрия: индустрия
красота: красоты красота
рынок: рынок
средство: средств средства средствам средствами
личной: личной
гигиена: гигиены
защитить: защищены
женщина: женщины женщин женщинам женщинами
воздействие: воздействия воздействии воздействием воздействию
токсичный: токсичных токсичными токсичные
вещество: веществ веществами веществам вещества веществом
новость: новости
оон: оон
перейти: перейти
основное: основному основном
добро: добро
пожаловать: пожаловать
русский: русский
другой: другие другого других
глобальный: глобальный глобальному
взгляд: взгляд
человеческий: человеческие человеческий
судьба: судьбы
поиск: поиск
расширить: расширенный
язык: язык
меню: меню
главный: главная
азия: азия
америка: америка
африка: африка
ближний: ближний
восток: восток
европа: европа
тема: темы тема теме
гуманитарный: гуманитарная
помощь: помощь
беженец: беженцы
мигрант: мигранты
здравоохранение: здравоохранение здравоохранения
климат: климат
окружать: окружающая
среда: среда
культура: культура
образование: образование
международный: международное
правый: право права прав
мир: мир мире
безопасность: безопасность
генеральный: генеральный генерального
секретарить: секретарь секретаря
человек: человека людям
цель: цели
устойчивый: устойчивого
развитие: развития развитие
экономический: экономическое
подробный: подробнее
интервью: интервью
сюжет: сюжеты
экспресс-новости: экспресс-новости
фоторепортаж: фоторепортажи
пресс-секретарь: пресс-секретарь
выступление: выступления
заявление: заявления
пресса: прессой
официальный: официальные
поездка: поездки
фотография: фотографии
пресс-релиз: пресс-релизы
группа: группа
аккредитация: аккредитации
сми: сми
интернет-трансляция: интернет-трансляция
аудиотека: аудиотека
подписаться: подписаться
фото: фото
юнеп: юнеп
ряд: ряде ряд
страна: стран странах страны
использование: использование использованием использования использовании
микропластика: микропластика
косметика: косметике косметика
запретить: запрещено запретить
законодательный: законодательном
уровень: уровне уровни
печать: печать
октябрь: октября
многие: многие многих
заболевание: заболевания заболеваниям заболеваний заболеванием
женский: женской женским женских женские женскими женское
половой: половой половые половыми половых
система: системы системе систему
мочь: могут могли
связанный: связаны связано связанные связанный
токсичность: токсичностью токсичности
потребительский: потребительских
товар: товаров товарах
включать: включая
косметический: косметические косметическими косметических
гигиенический: гигиенические
который: которыми который которой которая которого которые которым
регулярно: регулярно
пользоваться: пользуются пользоваться
маленький: мало меньше
задумываться: задумывается
считать: считая
продукция: продукция продукцией
лежать: лежит
прилавок: прилавках
значит: значит
принести: принесет
вред: вреда вред вреде
независимый: независимый
эксперт: эксперт
маркос: маркос
орельяна: орельяна
утверждать: утверждает
это: это этим
далеко: далеко
подчеркивать: подчеркивает
свое: своем свое
новый: новом новых
доклад: докладе доклад
рассчитать: рассчитаны
помогать: помогать
защищать: защищать
физический: физическое
психический: психическое психических
здоровье: здоровье здоровья
негативный: негативного негативно негативными
первый: первую
очередь: очередь
посвятить: посвящен посвященное
гендерный: гендерным гендерными гендерного
аспект: аспектам
влияние: влияния влиянии
материал: материалов материалы
вывод: выводы
утешительный: утешительны
страдать: страдают страдающих
значительно: значительно
больший: большей большие
степень: степени
мужчина: мужчины мужчин
занимать: занимает
пост: пост
специальный: специального специальный специальные
докладчик: докладчика докладчик
вопрос: вопросу вопросы
последствие: последствиях последствия последствиями
регулирование: регулирования
удаление: удаления
опасный: опасных
отходы: отходов
производство: производство
такой: таких такими такого такие таким
ароматизированный: ароматизированные
прокладка: прокладки прокладках
отчасти: отчасти
сексистскими: сексистскими
стереотип: стереотипами стереотипах
предрассудок: предрассудками предрассудки
ориентировать: ориентирована
вызвать: вызванным вызванных
уделяться: уделяется
достаточно: достаточно
внимание: внимания
медицинский: медицинские медицинских
стандарт: стандарты
носить: носят носит
андроцентричный: андроцентричный
характер: характер
год: году
процент: процент процентов процентах
исследование: исследований исследования исследование
инновация: инноваций
касаться: касался касается касающиеся
чистый: чисто
кроме: кроме
онкологический: онкологических
потребность: потребности потребностей
область: области
лечение: лечения
гормональный: гормональных
расстройство: расстройств
сердечно-сосудистый: сердечно-сосудистых
репродуктивный: репродуктивной репродуктивном
отличаться: отличаются
тот: тех
случай: случаях случаев
причинять: причиняемый
они: ими ними
являться: является являются являющийся
значительный: значительным
повсеместный: повсеместный
зачастую: зачастую
проводиться: проводятся
разбивка: разбивки
признак: признаку
пол: пола
например: например
организация: организация организациями
сеть: сеть
действие: действий
борьба: борьбе
пестицид: пестицидами
сообщить: сообщила
непреднамеренный: непреднамеренных
острый: острых острую
отравление: отравлений
ежегодно: ежегодно
миллион: миллионов миллионы
фермер: фермеров
сельскохозяйственный: сельскохозяйственных
рабочий: рабочих
однако: однако
известно: известно
какой: какую
часть: часть
составлять: составляют
работник: работники работников
менее: менее
склонный: склонны
верить: верить
часто: часто
игнорировать: игнорируют
жалоба: жалобы жалобам жалобами
число: числе
болезный: болезней
усугубить: усугубленных
канада: канаде
жаловаться: жалующиеся
чувствительность: чувствительность
химический: химическим химических химические
сталкиваться: сталкиваются
врач: врачей
выражаться: выражающимися
скептический: скептическом
отношение: отношении
также: также
скорый: скорее
направить: направят
психолог: психологу
профильный: профильному
специалист: специалисту
чаща: чаще
обращаться: обращаются
сексизма: сексизма
шанс: шансов
постановка: постановку постановки
диагноз: диагноза
отметить: отметил
спецдокладчик: спецдокладчик
недостаточно: недостаточно
осведомить: осведомлены
экология: экологии
целый: целом
гинекологический: гинекологические гинекологических
болезнь: болезни
один: одна одной одним одного
хронический: хронических
все: всем
характеризоваться: характеризуется
сложный: сложным
набор: набором
симптом: симптомов
боль: боли боль
тазовый: тазовой
обильный: обильные
кровотечение: кровотечения
бесплодие: бесплодие бесплодия
эндометриоз: эндометриоз
заболеваемость: заболеваемость
стремительно: стремительно
расти: растет
некоторые: некоторые некоторых
указывать: указывают
диоксин: диоксинов
больной: больные
эндометриозом: эндометриозом
вынудить: вынуждены
терпеть: терпеть
недоверие: недоверием
сторона: стороны сторонами
долгий: долго
ждать: ждут
основной: основных
причина: причин причиной
синдром: синдром
поликистоза: поликистоза
яичник: яичников
связывать: связывают
эндокринный: эндокринную
ощущаться: ощущаться
протяжение: протяжении
несколько: несколько
поколенье: поколений
восемь: восьми
возраст: возрасте
знать: знают
быстро: быстро
распространяться: распространяющимся
фибромиома: фибромиома
матка: матки
результат: результаты результате
возможный: возможную
связь: связь
фталатами: фталатами
содержаться: содержащимися содержатся содержится
упаковка: упаковках
продукт: продуктов
питание: питания
менструация: менструация менструацией менструации
орган: органы органами органов
особенно: особенно
сказываться: сказываться
природа: природой
женственность: женственностью женственности
табуируется: табуируется
гениталии: гениталии
уязвимый: уязвимы
кожа: кожа кожи
обладать: обладает
особый: особой
впитывать: впитывающей
способность: способностью
напоминать: напоминает
право: праве
доступ: доступ
менструальный: менструальной менструальных
содержать: содержащим содержать содержит содержат
вредный: вредных вредные
производитель: производители
эксплуатировать: эксплуатируют
неприятный: неприятных
вагинальный: вагинальных
запах: запахах
время: время
предлог: предлогом
добавлять: добавляют
аромат: ароматы
качество: качестве
решение: решения
надумать: надуманной
проблема: проблемы проблема проблем
нередко: нередко
предлагаться: предлагается
спринцевание: спринцевание
организм: организм
подвергаться: подвергается
входить: входящих
состав: состав составе
спринцовка: спринцовок
фталатов: фталатов
ход: ходе
недавний: недавних недавнего
обнаружить: обнаружены
свинец: свинец
мышьяк: мышьяк
известный: известными
канцероген: канцерогенами
автор: авторы
подсчитать: подсчитали
выделяться: выделяется
средний: среднем
миллиард: млрд
наночастиц: наночастиц
пластик: пластика пластиком
трус: трусы
предназначить: предназначенные
многократный: многократного
пфас: пфас
пер-: пер-
полифторалкильные: полифторалкильные
сообщаться: сообщается
замалчиваться: замалчивается
правительство: правительства
большинство: большинства
принимать: принимают принимать
никакой: никаких
мера: мер мерах меры
потребитель: потребители
легко: легко
получать: получать
информация: информацию информации информация
использовать: используемых используемым используют
реклама: реклама рекламой
социальный: социальный
статус: статус
зависеть: зависит
насколько: насколько
привлекательно: привлекательно
профессионально: профессионально
молодо: молодо
выглядеть: выглядит
поэтому: поэтому
различный: различными
попытка: попытки
проявлять: проявлять
осторожность: осторожность
подавляться: подавляются
агрессивный: агрессивной
играть: играющей
чувство: чувстве
неуверенность: неуверенности
характерный: характерном
патриархальный: патриархальным
уклад: укладом
жизнь: жизни
усугубляться: усугубляется
отсутствие: отсутствием
надлежащий: надлежащей
маркировка: маркировки маркировка
достоверный: достоверной
проверка: проверка
предмет: предмет
содержание: содержания
триклозана: триклозана
парабенов: парабенов
влиять: влияющих
провести: проведенная проведенного
азиатский: азиатских
показать: показала
полный: полной
объем: объемы
распрямление: распрямления
волос: волос
сей: сих
пора: пор
формальдегид: формальдегид
канцерогенный: канцерогенным
масштабный: масштабное
главное: главным главные
образ: образом
африканский: африканского
происхождение: происхождения
выявить: выявило
повышенный: повышенный
риск: риск риски
рак: рака
тринидад: тринидаде
тобаго: тобаго
проверить: проверено
продавать: продаваемых
рецепт: рецепта
кремовый: кремов
осветление: осветления
выясниться: выяснилось
ртуть: ртуть ртути
шесть: шести
концентрация: концентрация концентрации
превышать: превышает
предельный: предельные
установить: установленные
минаматской: минаматской
конвенция: конвенцию
три: трех
достигать: достигает
критический: критических
значение: значений
попадание: попадание
дерматологический: дерматологических
нервный: нервных
почка: почками
индий: индии
продажа: продажа
стимулироваться: стимулируется
закреплять: закрепляющей
расистский: расистские
светлый: светлая
считаться: считается
привлекательный: привлекательной
маргинализированных: маргинализированных
община: общинах
несмотря: несмотря
отмечать: отмечает
компании-производители: компании-производители
выборочно: выборочно
финансировать: финансируют финансировать
выгодный: выгодные
манипулировать: манипулируют
дать: данными
преуменьшить: преуменьшить
самый: самым
вводить: вводя
заблуждение: заблуждение
общественность: общественность
власть: власти
препятствовать: препятствуя
продвижение: продвижению
безопасный: безопасных
альтернативный: альтернативных
рекомендация: рекомендации рекомендаций
спецдокладчика: спецдокладчика
предлагать: предлагает
государство: государствам
мнение: мнению
частность: частности
должен: должны
скорректировать: скорректировать
норма: нормы
определить: определенных
информировать: информировать
население: население
снижение: снижению
учет: учетом
фактор: фактора
выработать: выработать
требование: требования
регулировать: регулировать
рекламный: рекламную
деятельность: деятельность
ознакомление: ознакомления
сфера: сферы
активно: активно
консультироваться: консультироваться
подписываться: подписывайтесь
наш: нашу наши
рассылка: рассылку
загружать: загружайте
приложение: приложение
мобильный: мобильных
устройство: устройств
токсин: токсины
микропластик: микропластик
научный: научная
экспедиция: экспедиция
магатэ: магатэ
воды: водах
антарктика: антарктики
южный: южной
корея: корее
начаться: начался
финальный: финальный
раунд: раунд
переговоры: переговоров
соглашение: соглашению
загрязнение: загрязнении
день: дня
понедельник: понедельник
израиль-газа: израиль-газа
украина: украина
ресурс: ресурсы
партнер: партнеров
новостной: новостные
анонс: анонсы
журнал: журнал
отчет: отчеты
заседание: заседаниях
аудиовизуальный: аудиовизуальные
общение: общение
твиттер: твиттер
последний: последние
брифинг: брифингов
стенограмма: стенограммы
комментарий: комментарии
журналист: журналистов
интернет: интернете
фейсбук: фейсбук
вконтакте: вконтакте
контакт: контакты
сайт: сайтом
указатель: указатель
задавать: задаваемые
остерегаться: остерегайтесь
мошенничество: мошенничества
конфиденциальность: конфиденциальность
условие: условия
пользование: пользования
пожертвование: пожертвования