фон: фоне
летний: летней летняя
волна: волны волна волне волн
коронавирус: коронавируса коронавирус коронавирусом коронавирусе
европейский: европейское европейском европейского
бюро: бюро
воз: воз
подтверждать: подтверждает
вакцина: вакцины вакцин вакцина
снижать: снижают снижает
смертность: смертность смертности
новость: новости
оон: оон
перейти: перейти
основное: основному
добро: добро
пожаловать: пожаловать
русский: русский
другой: другие других
глобальный: глобальный
взгляд: взгляд
человеческий: человеческие
судьба: судьбы
поиск: поиск
расширить: расширенный
язык: язык
меню: меню
главный: главная
азия: азия
америка: америка
африка: африка
ближний: ближний
восток: восток
европа: европа
тема: темы теме
гуманитарный: гуманитарная
помощь: помощь помощи
беженец: беженцы
мигрант: мигранты
женщина: женщины
здравоохранение: здравоохранение здравоохранения
климат: климат
окружать: окружающая
среда: среда
культура: культура
образование: образование
международный: международное международного
правый: право права
мир: мир
безопасность: безопасность
генеральный: генеральный генерального
секретарить: секретарь секретаря
человек: человека людям люди человеком людей
цель: цели
устойчивый: устойчивого
развитие: развития развитие развитии
экономический: экономическое
подробный: подробнее
интервью: интервью
сюжет: сюжеты
экспресс-новости: экспресс-новости
фоторепортаж: фоторепортажи
пресс-секретарь: пресс-секретарь
выступление: выступления
заявление: заявления
пресса: прессой
официальный: официальные
поездка: поездки поездками
фотография: фотографии
пресс-релиз: пресс-релизы
группа: группа групп группы
аккредитация: аккредитации
сми: сми
интернет-трансляция: интернет-трансляция
аудиотека: аудиотека
подписаться: подписаться
возх: возх
мостафа: мостафа
рекомендовать: рекомендуют
риск: риска риском риск
продолжать: продолжать продолжает
вакцинация: вакцинацию вакцинации
печать: печать
август: августа
декабрь: декабря декабрь
год: года лет год
марта: март
снизить: снизили снизить
пандемия: пандемии
меньший: меньшей
мера: мере мерой меры
процент: процентов процент
спасти: спасли
миллион: миллиона миллионов
жизнь: жизней жизнь
регион: регионе региона
всемирный: всемирной
организация: организации
таков: таковы
результат: результаты
новый: нового новыми новых новом
исследование: исследования
опубликовать: опубликованного
журнал: журнале журнал
ланцет: ланцет
зарегистрировать: зарегистрировано зарегистрированных
смерть: смертей смерти
однако: однако
число: число числа
мочь: могло могут
достигнуть: достичь
четыре: четырех
большинство: большинство
тот: тех
чей: чью
прививка: прививки прививка
это: это этим
возраст: возрасте возраста
старший: старше
представитель: представители
самый: самым
высокий: высоким
тяжелый: тяжелого тяжелых
течение: течения
заболевание: заболевания заболеваниями заболеваний
страна: страны стран
который: которые которых которой которым
внедрить: внедрили
программа: программы
ранний: ранней
такой: такие такое такими
бельгия: бельгия
дания: дания
исландия: исландия
ирландия: ирландия
израиль: израиль
королевство: королевство
нидерланды: нидерландов
мальта: мальта
соединить: соединенное
смочь: смогли
предоставить: предоставить
свое: своим
гражданин: гражданам
наиболее: наиболее
эффективный: эффективную эффективным эффективной эффективны
защита: защиту
актуальный: актуальны
сегодня: сегодня
спустя: спустя
заявить: заявила
являться: является
чрезвычайный: чрезвычайной чрезвычайно
ситуация: ситуацией
область: области
общественный: общественного
значение: значения
последний: последние
несколько: несколько
неделя: недель
ряд: ряд
сообщить: сообщили
всплеск: всплеске
случай: случаев случаи
доля: доля
пациент: пациентов пациенты
респираторный: респираторными респираторных респираторная
выявить: выявлен
условие: условиях условия
первичный: первичной
медико-санитарный: медико-санитарной
увеличиться: увеличилась увеличился
пять: пять
восемь: восемь
также: также
госпитализировать: госпитализированных
абсолютный: абсолютное
маленький: меньше
время: время
зимний: зимней
пик: пик
прийтись: пришелся
заражение: заражения
лето: летом
по-прежнему: по-прежнему
приводить: приводят приводить
госпитализация: госпитализациям госпитализаций госпитализации
обновить: обновленная
оставаться: остается
инструмент: инструментом
снижение: снижения
лицо: лиц
относиться: относятся
пожилой: пожилого
ослабить: ослабленным
иммунитет: иммунитетом
множественный: множественными множественные
сопутствовать: сопутствующими сопутствующих
беременная: беременные
медицинский: медицинский
персонал: персонал
кроме: кроме
шанс: шансы
называть: называемого
затяжной: затяжного
увеличение: увеличение
объяснить: объяснить
отпуск: отпуск
массовый: массовыми
мероприятие: мероприятиями
крупный: крупные
спортивный: спортивные
состязание: состязания
музыкальный: музыкальные
фестиваль: фестивали
конкуренция: конкуренцией
сторона: стороны
например: например
грипп: гриппа
отличие: отличие
сезонный: сезонного
циркулировать: циркулирует
круглый: круглый
этот: эта
картина: картина
измениться: изменится
вполне: вполне
ежегодно: ежегодно
наблюдаться: наблюдаться наблюдаются
инфекция: инфекции
создавать: создает
серьезный: серьезную
нагрузка: нагрузку
система: системы
защитить: защитить
помочь: поможет
использование: использование
маска: масок маска маску
многолюдный: многолюдных
помещение: помещениях
одноразовый: одноразовая
обеспечивать: обеспечивает
хороший: наилучшую
особенно: особенно
важный: важно
использовать: использовать
взаимодействие: взаимодействии
больной: больным
регулярный: регулярное
мытье: мытье
рука: рук
инфекционный: инфекционного
контроль: контроля
многие: многих
вирус: вирусов вирус
бактерия: бактерий
симптом: симптомы
температура: температура
кашель: кашель
усталость: усталость
одышка: одышка
следовать: следует следовать
пройти: пройти
тестирование: тестирование
последствие: последствий
иметь: имеют
получение: получение
противовирусный: противовирусных
препарат: препаратов
будущее: будущее
фаза: фаза
завершиться: завершилась
заражать: заражать
мнение: мнению
эксперт: экспертов
трудный: трудно
предсказать: предсказать
вести: вести
остаться: оставшуюся
часть: часть
возможный: возможны
настоятельно: настоятельно
призывать: призывают
сохранять: сохранять
бдительность: бдительность
рекомендация: рекомендациям
проводить: проводить
кампания: кампании
иммунизация: иммунизации
ориентироваться: ориентируясь
уязвимый: уязвимые
население: населения
иметься: имеющиеся
профилактика: профилактике
инфицированный: инфицированных
вариант: вариантами вариантов
подчеркивать: подчеркивают
специалист: специалисты
читать: читайте
предупреждать: предупреждает
рост: росте
заболеваемость: заболеваемости
подписываться: подписывайтесь
наш: нашу наши
рассылка: рассылку
загружать: загружайте
приложение: приложение
мобильный: мобильных
устройство: устройств
икао: икао
авиакомпания: авиакомпании
аэропорт: аэропорты
принимать: принимают
дополнительный: дополнительные
борьба: борьбы
глава: глава
мюнхен: мюнхене
паника: панике
слух: слухам
нужно: нужно
противопоставить: противопоставить
солидарность: солидарность
решительный: решительные
действие: действия
поддаваться: поддаваться
ресурс: ресурсы
информация: информация
партнер: партнеров
новостной: новостные
анонс: анонсы
отчет: отчеты
заседание: заседаниях
аудиовизуальный: аудиовизуальные
материал: материалы
общение: общение
твиттер: твиттер
главное: главные
брифинг: брифингов
стенограмма: стенограммы
комментарий: комментарии
журналист: журналистов
интернет: интернете
фейсбук: фейсбук
вконтакте: вконтакте
контакт: контакты
пользоваться: пользоваться
сайт: сайтом
указатель: указатель
часто: часто
задавать: задаваемые
вопрос: вопросы
остерегаться: остерегайтесь
мошенничество: мошенничества
конфиденциальность: конфиденциальность
пользование: пользования
пожертвование: пожертвования