жаркий: жаркая
погода: погода
влиять: влияет влиять
беременность: беременность беременности беременностей
два: две
будущее: будущие будущих
мама: мамы мам
задавать: задают задаваемые
вопрос: вопросы вопросов вопрос
акушерка: акушерке акушеркам акушерка
новость: новости
оон: оон
перейти: перейти
основное: основному
добро: добро
пожаловать: пожаловать
русский: русский
другой: другие
глобальный: глобальный
взгляд: взгляд
человеческий: человеческие
судьба: судьбы
поиск: поиск
расширить: расширенный
язык: язык
меню: меню
главный: главная
азия: азия
америка: америка америке
африка: африка
ближний: ближний
восток: восток
европа: европа европе
тема: темы теме
гуманитарный: гуманитарная
помощь: помощь
беженец: беженцы
мигрант: мигранты
женщина: женщины женщин
здравоохранение: здравоохранение
климат: климат климата
окружать: окружающая
среда: среда
культура: культура
образование: образование
международный: международное
правый: право права
мир: мир мира
безопасность: безопасность
генеральный: генеральный генерального
секретарить: секретарь секретаря
человек: человека люди людей
цель: цели
устойчивый: устойчивого
развитие: развития развитие
экономический: экономическое
подробный: подробнее
интервью: интервью
сюжет: сюжеты
экспресс-новости: экспресс-новости
фоторепортаж: фоторепортажи
пресс-секретарь: пресс-секретарь
выступление: выступления
заявление: заявления
пресса: прессой
официальный: официальные
поездка: поездки
фотография: фотографии
пресс-релиз: пресс-релизы
группа: группа групп
аккредитация: аккредитации
сми: сми
интернет-трансляция: интернет-трансляция
аудиотека: аудиотека
подписаться: подписаться
воз: воз
жар: жара жару жаре
негативный: негативно
сказываться: сказываться
состояние: состоянии состояние
беременная: беременных беременные
печать: печать
август: августа
повышение: повышение
температура: температуры температура температурах
изменение: изменения
происходить: происходит
быстрый: быстрее
любой: любом
друг: другом
регион: регионе
создавать: создает
риск: риски
такой: таких такая
население: населения
пожилой: пожилые
лицо: лица лице
хронический: хроническими
заболевание: заболеваниями
зависимость: зависимости
частота: частоты
интенсивность: интенсивности
продолжительность: продолжительности
период: периодов период
жары: жары
мочь: могут могу
страдать: страдать страдала страдаю страдают
также: также
плод: плода
николетта: николетт
митала: митала
орсолия: орсолия
хейм: хейм
ника: ники
орси: орси
двоюродный: двоюродные
сестра: сестры
который: которые которое которым который которых
жить: живут
будапешт: будапеште
венгрия: венгрия венгрии
год: лет год
оба: обеих обе
девушка: девушек
второй: второй
триместр: триместр
изнурять: изнуряющая
нынешний: нынешним
лето: летом лето
сказаться: сказалась
по-разному: по-разному
лишь: лишь
немного: немного
тошнота: тошноты
усталость: усталости усталость
кузина: кузина кузинам
переносить: переносила
горазд: гораздо
тяжелый: тяжелее
это: это
особенный: особенное
время: время
связанный: связано
радость: радостью
ожидание: ожиданием
оно: оно
сопрячь: сопряжено
тревога: тревогой тревогу
неопределенность: неопределенностью
делиться: делятся
свое: своим своем
опыт: опытом
влияние: влиянии
справиться: справиться
жара: жарой
встречаться: встречаются
один: одном
будапештский: будапештских
парок: парков
место: мест место
отдых: отдыха
тень: тени
несмотря: несмотря
рано: рано
достигнуть: достигла
градус: градусов
цельсий: цельсия
накануне: накануне
подниматься: поднималась
высокий: высокой высоких высокая
влажность: влажности
любить: люблю любила
зима: зиму
очень: очень
забеременеть: забеременев забеременела забеременеть
стать: стала стало
чувствовать: чувствовать
худой: хуже
появиться: появился
ряд: ряд
новый: новых
править: правил
стараться: стараюсь
следовать: следовать
носить: ношу носить
себя: собой
бутылка: бутылку
воды: воды
веер: веер
посещать: посещать
бассейн: бассейны бассейн
слишком: слишком
рассказывать: рассказывает
отличие: отличие
однако: однако
развиться: развилась
гипертония: гипертония
отечность: отечность
обручальный: обручальное
кольцо: кольцо
туфля: туфли
сандалия: сандалии
кроме: кроме
часто: часто
возникать: возникают
носовой: носовые
кровотечение: кровотечения
увеличение: увеличения
объем: объема
циркулировать: циркулирующей
кровь: крови кровь
характерный: характерного
этот: этими эта
симптом: симптомами
сложный: сложнее
проблема: проблемы
сохранять: сохраняет
позитивный: позитивный
настроить: настрой
протекать: протекает
сложно: сложно
волноваться: волнуюсь
рассчитывать: рассчитывать
врач: врача врачи врачам
участковый: участковой участков
медсестра: медсестры
все: всем
обследование: обследованиям
тест: тестам
мой: моей моего
дочь: дочерью
порядок: порядке
главное: главное главные
посоветовать: посоветовали
вести: вести
физически: физически
активный: активный активным
образ: образ
жизнь: жизни жизней
позволять: позволяет
выйти: выйти
улица: улицу улице
быть: будучи
профессия: профессии
физиотерапевт: физиотерапевтом
помогать: помогает
делать: делать
упражнение: упражнения
помещение: помещении помещениях
выходить: выходя
связь: связь
режим: режиме
онлайн: онлайн
счастье: счастью
дома: дома
работа: работе работу
кондиционер: кондиционеры
летний: летний
говорят: говорят
постоянно: постоянно
обрушиваться: обрушивается
огромный: огромное
количество: количество
информация: информации информация
интернет: интернете
вызывать: вызывает
замешательство: замешательство
мера: мере
приближение: приближения
срок: срока
роды: родов
предпочитать: предпочитают
обращаться: обращаться
совет: советом
дипломированный: дипломированная
кейт: кейт
гринсток: гринсток
великобритания: великобритании
отвечать: отвечает
некоторые: некоторые
возникнуть: возникших
ощущать: ощущают
наш: наши нашу
ребенок: дети ребенка
сильный: сильную
ответ: ответ
младенец: младенцы
утроба: утробе
мать: матери
таковой: таковую
реагировать: реагируют
ваш: вашем
организм: организме организма
поэтому: поэтому
нужно: нужно
поддерживать: поддерживали
водный: водный
баланс: баланс
перегреваться: перегревались
сократить: сократить
рабочий: рабочий
деть: день
путь: путь
домыть: домой
проводить: проводить
временить: времени
кондиционировать: кондиционированных
охладиться: охладиться
выпивать: выпивать выпивая
литр: литра
употреблять: употреблять
жидкость: жидкости
обычно: обычно
взять: возьмите
носов: носовой
платок: платок
смочить: смочить
вод: воде
использовать: использовать
охлаждение: охлаждения охлаждение
вредно: вредно
уровень: уровень
физический: физической физические
активность: активности
зависеть: зависит
конкретный: конкретного
нормально: нормально
сам: сами самого
понять: поймете
именно: именно
подходить: подходит
прогулка: прогулки
начало: начале
конец: конце
день: дня
хороший: хороший
способ: способ
оставаться: оставаться
возможность: возможность возможности
находиться: находиться
прохладный: прохладном
простой: простые
помочь: помогут
разогнать: разогнать
зарядить: зарядить
энергия: энергией
улучшить: улучшить
сон: сон
достаточный: достаточное
смочь: сможете
побороть: побороть
избежать: избежать
серьезный: серьезного
последствие: последствия
обезвоживание: обезвоживания
безопасно: безопасно
охлаждаться: охлаждаться
прекрасный: прекрасный
безопасный: безопасный безопасны
позаботиться: позаботиться
малыш: малыше
обязательно: обязательно
пользоваться: пользуйтесь пользоваться
солнцезащитный: солнцезащитным
крем: кремом
забывать: забывайте
головной: головной
убор: убор
найти: найдите
тенистый: тенистое
обгореть: обгореть
свести: свести
минимум: минимуму
вероятность: вероятность
появление: появления
кожа: коже
мелазмы: мелазмы
темный: темных
пятно: пятен
обесцветить: обесцвеченных
чаща: чаще
процент: процентов
читать: читайте
каждый: каждый
уносить: уносит
тысяча: тысяч
защитить: защитить
близкие: близких
подписываться: подписывайтесь
рассылка: рассылку
загружать: загружайте
приложение: приложение
мобильный: мобильных
устройство: устройств
насколько: насколько
вакцина: вакцины
планировать: планирующих
северный: северной
материнский: материнской
смертность: смертности
увеличиться: увеличился
пандемия: пандемия
обернуться: обернулась
рост: ростом
незапланированный: незапланированных
ресурс: ресурсы
партнер: партнеров
новостной: новостные
анонс: анонсы
журнал: журнал
отчет: отчеты
заседание: заседаниях
аудиовизуальный: аудиовизуальные
материал: материалы
общение: общение
твиттер: твиттер
последний: последние
брифинг: брифингов
стенограмма: стенограммы
комментарий: комментарии
журналист: журналистов
фейсбук: фейсбук
вконтакте: вконтакте
контакт: контакты
сайт: сайтом
указатель: указатель
остерегаться: остерегайтесь
мошенничество: мошенничества
конфиденциальность: конфиденциальность
условие: условия
пользование: пользования
пожертвование: пожертвования