юнисеф: юнисеф
здоровье: здоровью здоровье здоровья
миллион: миллионов миллиона млн
ребенок: детей детям ребенка
восточный: восточной
азия: азии азия
тихоокеанский: тихоокеанском тихоокеанских тихоокеанскому
угрожать: угрожает
загрязнение: загрязнение загрязнения загрязнением
воздух: воздуха воздухом воздух
новость: новости
оон: оон
перейти: перейти
основное: основному основном
добро: добро
пожаловать: пожаловать
русский: русский
другой: другие
глобальный: глобальный
взгляд: взгляд
человеческий: человеческие
судьба: судьбы
поиск: поиск
расширить: расширенный
язык: язык
меню: меню
главный: главная
америка: америка америке
африка: африка
ближний: ближний
восток: восток
европа: европа европе
тема: темы теме
гуманитарный: гуманитарная
помощь: помощь
беженец: беженцы
мигрант: мигранты
женщина: женщины
здравоохранение: здравоохранение здравоохранения
климат: климат климата
окружать: окружающая
среда: среда
культура: культура
образование: образование
международный: международное
правый: право права
мир: мир
безопасность: безопасность
генеральный: генеральный генерального
секретарить: секретарь секретаря
человек: человека людям
цель: цели
устойчивый: устойчивого
развитие: развития развитие развитию
экономический: экономическое экономические
подробный: подробнее
интервью: интервью
сюжет: сюжеты
экспресс-новости: экспресс-новости
фоторепортаж: фоторепортажи
пресс-секретарь: пресс-секретарь
выступление: выступления
заявление: заявления
пресса: прессой
официальный: официальные
поездка: поездки
фотография: фотографии
пресс-релиз: пресс-релизы
группа: группа
аккредитация: аккредитации
сми: сми
интернет-трансляция: интернет-трансляция
аудиотека: аудиотека
подписаться: подписаться
фото: фото
юнисефвсохин: юнисефвсохин
прогулка: прогулкой
воспитательница: воспитательница
детский: детского детском
сад: сада
монголия: монголии
надевать: надевает
маска: маски
печать: печать
февраль: февраля
каждый: каждый каждая
деть: день
младший: младше
пять: пяти пять
год: лет году год
умирать: умирают
остров: островах
предупреждать: предупреждают предупреждает
фонд: фонде
призывать: призывая
срочный: срочным срочный
мера: мерам мере меры мер
исследование: исследование
подчеркивать: подчеркивает подчеркивают
разрушительный: разрушительное
влияние: влияние
токсичный: токсичного
связанный: связана связано
четвертая: четвертая
смерть: смерть смертей
регион: регионе региону региона
воздействие: воздействие воздействию воздействия
загрязненный: загрязненного загрязненным
начинаться: начинается
утроба: утробе
мать: матери
повышать: повышая
риск: риски
преждевременный: преждевременных
роды: родов
низкий: низкого
вес: веса
рождение: рождении
продолжаться: продолжается
детство: детстве
ухудшать: ухудшая
состояние: состояние
дыхательный: дыхательной
система: системы систем
снижать: снижая
когнитивные: когнитивные
функция: функции
способствовать: способствуя
хронический: хронических
заболевание: заболеваний
такой: таких
астма: астма
сердечно-сосудистый: сердечно-сосудистые
патология: патологии
вдох: вдох
иметь: имеет
значение: значение
многие: многим
причинить: причинить
вред: вред
заявить: заявила
региональный: региональный
директор: директор
джуна: джун
кунуги: кунуги
читать: читайте
также: также
доклад: доклад
природа: природе
северный: северной
отчет: отчете отчеты
отмечаться: отмечается
жить: живут
страна: странах страны
подвергаться: подвергаются
годовой: годового
уровень: уровня уровнем уровень
мелкий: мелких
твердый: твердых
частица: частиц
превышать: превышающему
рекомендация: рекомендации рекомендациям
всемирный: всемирной всемирного
организация: организации
воз: воз
район: районах
опасный: опасным
диоксид: диоксида
азот: азота
газ: газа
выбрасывать: выбрасываемого
транспорт: транспортом
промышленный: промышленными
предприятие: предприятиями
сжигание: сжиганием
ископаемое: ископаемого
топливо: топлива
биомасса: биомассы
сельскохозяйственный: сельскохозяйственных
отходы: отходов
основной: основных
фактор: факторов
изменение: изменения
усиление: усиления усиление
экстремальный: экстремальных
погодный: погодных
явленье: явлений
стать: станет
серьезный: серьезной
угроза: угрозой угрозу
далекоидущие: далекоидущие
последствие: последствия
кризис: кризис
влиять: влияет
высокий: высокий
вынуждать: вынуждает
школа: школы
закрываться: закрываться
мешать: мешает
образовательный: образовательному
процесс: процессу
увеличивать: увеличивает
расход: расходы
медицинский: медицинское медицинских
обслуживание: обслуживание
создавать: создавая
дополнительный: дополнительную
нагрузка: нагрузку
оценка: оценкам
банк: банка
потеря: потери
составить: составили
триллион: триллиона
доллар: долларов
эквивалентный: эквивалентно
процент: процента
валовой: валового
внутренний: внутреннего
продукт: продукта
ввп: ввп
призыв: призыв
действие: действиям
ответ: ответ
призвать: призвали
правительство: правительства правительствами
бизнес: бизнес бизнесу бизнесом
работник: работников
родитель: родителей родители
педагог: педагогов педагоги
немедленно: немедленно
принять: принять
сокращение: сокращению
защита: защите
должен: должны
ужесточить: ужесточить
экологический: экологические экологических экологического
норма: нормы
переходить: переходить
чистый: чистые чистый чистых чистой
источник: источники
энергия: энергии
вводить: вводить
стандарт: стандарты
качество: качества
соответствующий: соответствующие
необходимо: необходимо
внедрять: внедрять
экологически: экологически
технология: технологии
сокращать: сокращать
выброс: выбросы
ставить: ставить
приоритет: приоритет
играть: играют
ключевой: ключевую
роль: роль
отстаивать: отстаивая
вовлекать: вовлекая
молодежь: молодежь
реализация: реализацию
инициатива: инициатив
эффективный: эффективные эффективной
решение: решения
сотрудничать: сотрудничает
сообщество: сообществами
ряд: ряду
направить: направленных
снижение: снижение
этот: этих
регулирование: регулирования
улучшение: улучшение
мониторинг: мониторинга
счет: счет
установка: установки
доступный: доступных
датчик: датчиков
программа: программы
дом: домах
включать: включая
внедрение: внедрение
кухонный: кухонных
плита: плит
улучшить: улучшенную
вентиляция: вентиляцию
агентство: агентство
работать: работает
укрепление: укреплением
диагностик: диагностики
лечение: лечения
вызвать: вызванных
поддерживать: поддерживает
стремление: стремлении
бороться: бороться
подписываться: подписывайтесь
наш: нашу наши
рассылка: рассылку
загружать: загружайте
приложение: приложение
мобильный: мобильных
устройство: устройств
борьба: борьба
мочь: могут
спасти: спасти
жизнь: жизни
ускорить: ускорить
вмо: вмо
являться: является
причина: причиной
саймон: саймон
стил: стил
переход: переход
остановить: остановить
ресурс: ресурсы
информация: информация
партнер: партнеров
новостной: новостные
анонс: анонсы
журнал: журнал
заседание: заседаниях
аудиовизуальный: аудиовизуальные
материал: материалы
общение: общение
твиттер: твиттер
последний: последние
главное: главные
брифинг: брифингов
стенограмма: стенограммы
комментарий: комментарии
журналист: журналистов
интернет: интернете
фейсбук: фейсбук
вконтакте: вконтакте
контакт: контакты
пользоваться: пользоваться
сайт: сайтом
указатель: указатель
часто: часто
задавать: задаваемые
вопрос: вопросы
остерегаться: остерегайтесь
мошенничество: мошенничества
конфиденциальность: конфиденциальность
условие: условия
пользование: пользования
пожертвование: пожертвования