процент: процентов процента
новый: новых новые
случай: случаев случаю случаи
заражение: заражения
вич: вич
подростковый: подростков
мир: мире мир мира
приходиться: приходится
девочка: девочек девочка девочки
новость: новости
оон: оон
перейти: перейти
основное: основному
добро: добро
пожаловать: пожаловать
русский: русский
другой: другие
глобальный: глобальный глобальной
взгляд: взгляд
человеческий: человеческие
судьба: судьбы
поиск: поиск
расширить: расширенный расширенного
язык: язык
меню: меню
главный: главная
азия: азия азии
америка: америка америке
африка: африка африки африке
ближний: ближний ближнем
восток: восток востоке
европа: европа европе
тема: темы тема теме
гуманитарный: гуманитарная
помощь: помощь
беженец: беженцы
мигрант: мигранты
женщина: женщины женщинам женщин
здравоохранение: здравоохранение здравоохранения
климат: климат
окружать: окружающая
среда: среда
культура: культура
образование: образование
международный: международное
правый: право права прав
безопасность: безопасность
генеральный: генеральный генерального
секретарить: секретарь секретаря
человек: человека людей
цель: цели
устойчивый: устойчивого
развитие: развития развитие
экономический: экономическое
подробный: подробнее
интервью: интервью
сюжет: сюжеты
экспресс-новости: экспресс-новости
фоторепортаж: фоторепортажи
пресс-секретарь: пресс-секретарь
выступление: выступления
заявление: заявления
пресса: прессой
официальный: официальные
поездка: поездки
фотография: фотографии
пресс-релиз: пресс-релизы
группа: группа группе
аккредитация: аккредитации
сми: сми
интернет-трансляция: интернет-трансляция
аудиотека: аудиотека
подписаться: подписаться
юнисефдж: юнисефдж
пироцци: пироцци
-летняя: -летняя
вич-положительная: вич-положительная
рисовать: рисует
поддерживать: поддерживаемом
юнисеф: юнисеф
центр: центре
ташкент: ташкенте
узбекистан: узбекистан
печать: печать
декабрь: декабря
последний: последнее последним последние
десятилетие: десятилетие десятилетия
все: всем
наблюдаться: наблюдалось
заметный: заметное
снижение: снижение снижения
число: числа числе число
ребенок: детей дети ребенку
однако: однако
некоторые: некоторые
тинейджер: тинейджеры тинейджеров
особенно: особенно
получать: получают
необходимый: необходимых необходимой
социальный: социальных
медицинский: медицинских
услуга: услуг услугам
профилактический: профилактических
преддверие: преддверии
всемирный: всемирного всемирный
день: дня
борьба: борьбы борьбе
спид: спидом спид
который: который которых
отмечаться: отмечается
детский: детском
фонд: фонде
призывать: призывают призываю
принять: принять
срочный: срочные
мера: меры мере
оказание: оказанию
поддержка: поддержки
девочкам-подросткам: девочкам-подросткам
молодая: молодым
уязвимый: уязвимых
регион: регионах регионов регионе
первый: первую
очередь: очередь
страна: странах страны стран
тропический: тропической
прийтись: пришлось пришлись
иметься: имеющимся
дать: данным
год: году лет года
тысяча: тысяч
мальчик: мальчиков
возраст: возрасте
инфицировать: инфицированы
показатель: показатель показателей
достигать: достигает
многие: многие
добиться: добились
значительный: значительных
успех: успехов успехи
сказать: сказала
заместитель: заместитель
директор: директора
анурита: анурита
бейнс: бейнс
подросток: подростки
полный: полной
пользоваться: пользуются пользоваться
плод: плодами
доступ: доступа доступ доступу
лечение: лечения
профилактика: профилактики
жить: живущие живущих
должен: должны
приоритет: приоритете
речь: речь
идти: идет
инвестирование: инвестировании
ресурс: ресурсов ресурсы
усилие: усилий
расширение: расширению расширение
масштаб: масштабов
это: это
включать: включает включая
использование: использования
инновационный: инновационных
технология: технологий
тестирование: тестирования
пояснить: пояснила
тот: тех
проходить: проходит проходят
курс: курс
взрослый: взрослых
зарегистрировать: зарегистрировано
возрастной: возрастной
результат: результате
общий: общее общих
достигнуть: достигло достичь
миллион: миллиона
время: время
вич-позитивных: вич-позитивных
антиретровирусную: антиретровирусную
терапия: терапию
прошлый: прошлом
умереть: умерли
причина: причин
связанный: связанных
смерть: смертей
воодушевлять: воодушевляющие
восточный: восточной
южный: южной
снизиться: снизилось
один: одно
главное: главных главные
достижение: достижений
сфера: сфере
мировой: мирового
общественный: общественного
территория: территорий
получить: получили
сертификация: сертификацию
ликвидация: ликвидации
передача: передачи
сифилис: сифилиса
мать: матери
государство: государств
белиз: белиз
ямайка: ямайку
сент-винсент: сент-винсент
гренадины: гренадины
ботсвана: ботсвана
намибия: намибия
сертифицировать: сертифицированы
находиться: находящиеся
путь: пути путь
удаться: удалось
стать: стали
возможный: возможными
солидарность: солидарности
уважение: уважению
заявить: заявил
антониу: антониу
гутерриш: гутерриш
по-прежнему: по-прежнему
серьезный: серьезная
угроза: угроза
вместе: вместе
напоминать: напоминают
несмотря: несмотря
инфицирование: инфицирования
большинство: большинстве
западный: западной
центральный: центральной
тихоокеанский: тихоокеанском
латинский: латинской
карибский: карибском
бассейн: бассейне
существенный: существенного
уровень: уровня
северный: северной
увеличиться: увеличились
победить: победим
каждый: каждого
быть: будут
защитить: защищены
дискриминационный: дискриминационные
закон: законы
политик: политика
практик: практика
служить: служат
средство: средствами средствам
наказание: наказания
стигматизация: стигматизации
представитель: представителей
меньшинство: меньшинств
препятствовать: препятствуя
проверить: проверенным
уход: ухода
отметить: отметил
глава: глава
подчеркнуть: подчеркнул
слоган: слоган
выбирать: выбирайте
правильный: правильный
лидер: лидеров
прислушаться: прислушаться
пойти: пойти
правозащитный: правозащитному
подытожить: подытожил
генсек: генсек
подписываться: подписывайтесь
наш: нашу наши
рассылка: рассылку
загружать: загружайте
приложение: приложение
мобильный: мобильных
устройство: устройств
деть: день
генассамблея: генассамблее
обсудить: обсудили
прогресс: прогресс
искоренение: искоренении
ликвидировать: ликвидировать
неравенство: неравенство
юнэйдс: юнэйдс
равноправие: равноправие
победа: победе
информация: информация
партнер: партнеров
новостной: новостные
анонс: анонсы
журнал: журнал
отчет: отчеты
заседание: заседаниях
аудиовизуальный: аудиовизуальные
материал: материалы
общение: общение
твиттер: твиттер
брифинг: брифингов
стенограмма: стенограммы
комментарий: комментарии
журналист: журналистов
интернет: интернете
фейсбук: фейсбук
вконтакте: вконтакте
контакт: контакты
сайт: сайтом
указатель: указатель
часто: часто
задавать: задаваемые
вопрос: вопросы
остерегаться: остерегайтесь
мошенничество: мошенничества
конфиденциальность: конфиденциальность
условие: условия
пользование: пользования
пожертвование: пожертвования