невозможный: невозможного
оон: оон
помогать: помогает
отстаивать: отстаивать
правый: права право прав
человек: людей человека люди
инвалидность: инвалидностью инвалидности инвалидность
молдова: молдове молдова молдовы
новость: новости
перейти: перейти
основное: основному
добро: добро
пожаловать: пожаловать
русский: русский
другой: другие другими
глобальный: глобальный
взгляд: взгляд
человеческий: человеческие
судьба: судьбы
поиск: поиск
расширить: расширенный
язык: язык языке
меню: меню
главный: главная
азия: азия
америка: америка
африка: африка
ближний: ближний
восток: восток
европа: европа
тема: темы теме
гуманитарный: гуманитарная
помощь: помощь
беженец: беженцы
мигрант: мигранты
женщина: женщины женщина
здравоохранение: здравоохранение здравоохранения
климат: климат
окружать: окружающая
среда: среда
культура: культура
образование: образование
международный: международное международными
мир: мир
безопасность: безопасность
генеральный: генеральный генерального
секретарить: секретарь секретаря
цель: цели
устойчивый: устойчивого
развитие: развития развитие
экономический: экономическое экономической
подробный: подробнее
интервью: интервью
сюжет: сюжеты
экспресс-новости: экспресс-новости
фоторепортаж: фоторепортажи
пресс-секретарь: пресс-секретарь
выступление: выступления
заявление: заявления
пресса: прессой
официальный: официальные официальным
поездка: поездки
фотография: фотографии
пресс-релиз: пресс-релизы
группа: группа группам групп
аккредитация: аккредитации
сми: сми
интернет-трансляция: интернет-трансляция
аудиотека: аудиотека
подписаться: подписаться
увкпчвтремо: увкпчвтремо
диана: диана дианы
жалба: жалба
считать: считает
печать: печать
январь: января
любить: любит люблю
говорить: говорить говорит
должен: должны
позволять: позволять
ограничивать: ограничивать
подчеркивать: подчеркивает
подвижной: подвижная
разговорчивый: разговорчивая
-летняя: -летняя
церебральный: церебральным
паралич: параличом
нравиться: нравится
жить: жить живут
один: одной одна
свой: своей
квартира: квартире
отвечать: отвечать
жизнь: жизнь жизни
сам: сама самое
оплачивать: оплачиваю
счет: счета
ходить: хожу
кино: кино
хотеться: хочется
нужно: нужно
никто: никому
объяснять: объяснять объясняет
единственный: единственная
проблема: проблема проблемах
это: это
преодоление: преодоление
барьер: барьеров
недавно: недавно
завершить: завершила
программа: программу программ программе
стажировка: стажировки стажировка
который: которую которые которая которых
проводить: проводит
призвать: призвана
поддержать: поддержать
инклюзивность: инклюзивность
добиться: добиться добилась
соблюдение: соблюдения
принадлежать: принадлежащих
уязвимый: уязвимым
часто: часто
сталкиваться: сталкиваются
дискриминация: дискриминацией дискриминации
работать: работая работает работать
наставник: наставниками
стажер: стажеры
получать: получают
практический: практический
опыт: опыт
приобретать: приобретают
профессиональный: профессиональные профессиональном профессиональной
навык: навыки
необходимый: необходимые необходимым
будущее: будущего
трудоустройство: трудоустройства
число: числе
помочь: помогла помогло
личной: личном
план: плане
степень: степень
магистр: магистра
иностранный: иностранных
языковый: языков
литература: литературы
девушка: девушка
переводчик: переводчиком
нпо: нпо
кишинев: кишиневе
научиться: научилась
справляться: справляться
свое: своими
эмоция: эмоциями
фокусироваться: фокусироваться
хотеть: хочу хотим
делать: делать
рассказывать: рассказывает
печатать: печатаю
также: также
использовать: использую
голосовой: голосовую
система: систему
объяснить: объяснила
дома: дома
точность: точность
проверять: проверяю
каждый: каждое каждую
слово: слово словам
запятая: запятую
мочь: могу могут
очень: очень
придирчивый: придирчивой
доверять: доверяю
добавлять: добавляет
смеяться: смеется
ратифицировать: ратифицировала
конвенция: конвенцию конвенции
право: правах правам
инвалид: инвалидов инвалиды инвалидами
год: году года
ратификация: ратификация
привести: привела
важный: важным важнейшим важно
реформа: реформам реформ
законодательный: законодательным законодательных
изменение: изменениям изменения
включать: включая включает
принятие: принятие принятия
закон: закона
социальный: социальной социальную социальными
интеграция: интеграции
однако: однако
борьба: борьба борьбы
далекий: далека
завершение: завершения
существовать: существует
множество: множество
общественный: общественной
дать: данным
самый: самых
бедный: бедных
уровень: уровень уровня
занятость: занятости
составлять: составляет
половина: половину
население: населения
целый: целом
ограничить: ограниченными ограниченное
возможность: возможностями возможности
особенно: особенно
сельский: сельской
местность: местности
высокий: высоким
риск: риском
насилие: насилия
бедность: бедности
изоляция: изоляции
управление: управление управления управлением
партнер: партнерами партнеров
гражданский: гражданским гражданской гражданского
общество: обществом общества обществе
представлять: представляющими
организация: организациями организации организация
правительство: правительством правительство
дальнейший: дальнейшего
продвижение: продвижения продвижению продвижение
реализация: реализации
наставница: наставницей
ксения: ксенией ксения
симинчук: симинчук
этот: эта
работа: работа работу
обучение: обучение
предоставление: предоставление
рекомендация: рекомендаций
консультация: консультаций консультации
разработка: разработки
соответствующий: соответствующей
политик: политики политика
иметь: имеют
вести: вести
достойный: достойную
независимый: независимую
наравне: наравне
сотрудник: сотрудник
время: время
стать: стали
близкие: близкими
подруга: подругами
жалбе: жалбе
составить: составить
грамотный: грамотное
резюме: резюме
подготовиться: подготовиться
собеседование: собеседованию
офис: офисе
народный: народного
адвокат: адвоката
мы: нам
необходимо: необходимо
изменить: изменить
подход: подход
рассматривать: рассматривать
участник: участников
соавтор: соавторов
культурный: культурной
политический: политической
наш: нашего нашу наши
государственный: государственная государственный
василь: василе
кушка: кушка кушки
министерство: министерства министерство
труд: труда
защита: защиты защиту
заявить: заявил
приверженный: привержено
адекватный: адекватную
адаптация: адаптацию
учебный: учебных учебные
заведение: заведений заведения
улучшение: улучшение
подготовка: подготовки
большой: большого
прогресс: прогресса
область: области
продолжать: продолжать
сказать: сказал
разработать: разработала
одноименный: одноименную
национальный: национальную
деинституционализации: деинституционализации
совместный: совместную
механизм: механизмами
несмотря: несмотря
финансирование: финансирование
взаимодействовать: взаимодействует
направить: направленных
участие: участие
лицо: лиц
являться: является
элемент: элементом
инклюзивности: инклюзивности
пересмотр: пересмотра
правовой: правовых
рамка: рамок
стереотип: стереотипами
негативный: негативными
убеждение: убеждениями
подчеркнуть: подчеркнул
людмила: людмила людмилы
адамчук: адамчук
дочка: дочкой дочки
беатрис: беатрис
менталитет: менталитет
главное: главное главные
семилетней: семилетней
синдром: синдром
дауна: дауна
активистка: активистка
выступать: выступающая
поддержка: поддержке поддержки
основать: основала
друг: друг
румынский: румынском
повышать: повышает повышать
осведомленность: осведомленность
расширять: расширяет
родитель: родителей
ребенок: детей
полный: полного
слышать: слышим
случай: случаях
принимать: принимают
предлог: предлогом
квалифицированный: квалифицированного
персонал: персонала
пример: примеры
почему: почему
менять: менять
квалификация: квалификацию
специалист: специалистов
предоставлять: предоставлять предоставляет
доступ: доступ
служба: службам
устранение: устранение
супруг: супруги
валерий: валерий
шемянский: шемянский
галина: галина
федотов: федотова
активист: активисты
бороться: борются
родиться: родившийся
президент: президент
приднестровье: приднестровье
юридический: юридические
медицинский: медицинские
психологический: психологические
пар: пара
принять: приняла
оптимизировать: оптимизировать
сотрудничать: сотрудничает
де-факто: де-факто
власть: властями
стараться: стараясь
внести: внести
нормативный: нормативную
баз: базу
обеспечить: обеспечить
льгота: льготами
многие: многие
знать: знают
такой: такие
остальное: остальных
подписываться: подписывайтесь
рассылка: рассылку
загружать: загружайте
приложение: приложение
мобильный: мобильных
устройство: устройств
процент: процентов
развивающийся: развивающихся
страна: странах
южет: южет
защитить: защитить
травля: травли
заместительный: заместительная
терапия: терапия
наркозависимости: наркозависимости
доступный: доступна
тюрьма: тюрьмах
ресурс: ресурсы
информация: информация
новостной: новостные
анонс: анонсы
журнал: журнал
отчет: отчеты
заседание: заседаниях
аудиовизуальный: аудиовизуальные
материал: материалы
общение: общение
твиттер: твиттер
последний: последние
брифинг: брифингов
стенограмма: стенограммы
комментарий: комментарии
журналист: журналистов
интернет: интернете
фейсбук: фейсбук
вконтакте: вконтакте
контакт: контакты
пользоваться: пользоваться
сайт: сайтом
указатель: указатель
задавать: задаваемые
вопрос: вопросы
остерегаться: остерегайтесь
мошенничество: мошенничества
конфиденциальность: конфиденциальность
условие: условия
пользование: пользования
пожертвование: пожертвования