обстрел: обстрелы обстрелами
бомбардировка: бомбардировки
задерживать: задерживают
кампания: кампанию кампании кампания
вакцинация: вакцинации вакцинацию вакцинация
полиомиелит: полиомиелита полиомиелитом полиомиелит
север: севере
газ: газы газе газа
новость: новости
оон: оон
перейти: перейти
основное: основному
добро: добро
пожаловать: пожаловать
русский: русский
другой: другие
глобальный: глобальный
взгляд: взгляд
человеческий: человеческие
судьба: судьбы
поиск: поиск
расширить: расширенный
язык: язык
меню: меню
главный: главная
азия: азия
америка: америка
африка: африка
ближний: ближний
восток: восток
европа: европа
тема: темы теме
гуманитарный: гуманитарная гуманитарной гуманитарные
помощь: помощь помощи
беженец: беженцы беженцев
мигрант: мигранты
женщина: женщины
здравоохранение: здравоохранение здравоохранения
климат: климат
окружать: окружающая
среда: среда среду
культура: культура
образование: образование
международный: международное
правый: право права
мир: мир
безопасность: безопасность
генеральный: генеральный генерального
секретарить: секретарь секретаря
человек: человека человек людей
цель: цели
устойчивый: устойчивого
развитие: развития развитие
экономический: экономическое
подробный: подробнее
интервью: интервью
сюжет: сюжеты
экспресс-новости: экспресс-новости
фоторепортаж: фоторепортажи
пресс-секретарь: пресс-секретарь
выступление: выступления
заявление: заявления заявлении
пресса: прессой
официальный: официальные
поездка: поездки
фотография: фотографии
пресс-релиз: пресс-релизы
группа: группа
аккредитация: аккредитации
сми: сми
интернет-трансляция: интернет-трансляция
аудиотека: аудиотека
подписаться: подписаться
фото: фото
настоящее: настоящее
время: время
осада: осаде осады
постоянный: постоянными
сектор: сектора секторе
находиться: находятся
примерный: примерно
тысяча: тысяч
печать: печать
октябрь: октября
интенсивный: интенсивные
массовый: массовое массовая
перемещение: перемещение
отсутствие: отсутствие
доступ: доступа доступ
северный: северной
частить: части
вынудить: вынудили вынуждены
агентство: агентства агентство
отложить: отложить
сообщить: сообщила
всемирный: всемирная всемирного
организация: организация организации
воз: воз
успешный: успешного
проведение: проведения
необходимый: необходимы необходимое
пауза: паузы
боев: боевых
действие: действиях действия
позволять: позволяющие
доставлять: доставлять
медицинский: медицинские медицинских медицинскому
учреждение: учреждения
семья: семьям семей
безопасно: безопасно
добираться: добираться
место: мест
мобильный: мобильным мобильных
бригада: бригадам
работник: работников работники
вакцинировать: вакцинировать
ребенок: детей
говориться: говорится
опубликовать: опубликованном
накануне: накануне
день: дня
борьба: борьбы
который: который которой
ежегодно: ежегодно
отмечать: отмечают
объединить: объединенных
нация: наций
детский: детский
фонд: фонд
юнисеф: юнисеф
ближневосточный: ближневосточное
дело: делам
палестинский: палестинских
бапор: бапор
третий: третий
последний: последний последние
этап: этап этапа
должен: должен
стартовать: стартовать
сегодня: сегодня
ход: ходе
собираться: собирались
вторник: вторник
обратиться: обратились
израильский: израильским
власть: властям
просьба: просьбой
предоставить: предоставить
немедленный: немедленный
доставка: доставки
жизненно: жизненно
важный: важной
часть: часть
заявить: заявила
нынешний: нынешняя
ситуация: ситуация
включать: включая
продолжаться: продолжающиеся продолжающейся
атака: атаки
гражданский: гражданскую
инфраструктура: инфраструктуру
ставить: ставит
угроза: угрозу
передвижение: передвижение
делать: делая
невозможный: невозможным
безопасный: безопасное
сопровождение: сопровождение
свое: своих
выполнение: выполнение
свой: своей
миссия: миссии
второй: второй вторую
слово: словам
представитель: представителей
сегодняшний: сегодняшний
деть: день
материально-технический: материально-технические
ресурс: ресурсы
профессиональный: профессиональные
кадры: кадры
готовый: готовы
доза: дозой дозы дозу
новый: новой новым
оральный: оральной
полиомиелитный: полиомиелитной
вакцина: вакцины
первый: первый
раунд: раунд раунда
проводиться: проводился
сентябрь: сентября
тот: тех
пора: пор
территория: территория
разрешить: разрешены
временной: временные
значительно: значительно
сократиться: сократилась
ограничиваться: ограничивается
город: городом
маленький: меньше
первое: первого
хиннави: хиннави
возвращение: возвращение
начало: начале
год: года год
спустя: спустя
четверть: четверть
век: века
искоренение: искоренения
опасный: опасного
заболевание: заболевания
зарегистрировать: зарегистрирован
случай: случай случаям
явиться: явилось
один: одним
последствие: последствий
война: войны
именно: именно
это: это
побудить: побудило
партнер: партнеров
развернуть: развернуть
анклав: анклаве
прервать: прервать
передача: передачу передачи
полиовируса: полиовируса
распространение: распространение
необходимо: необходимо
менее: менее
процент: процентов
каждый: каждой каждом
община: общине
район: районе
вызывать: вызывает
паралич: паралич
тяжелый: тяжелые
симптом: симптомы
распространяться: распространяться
очень: очень
быстро: быстро
задержка: задержка
введение: введением
течение: течение
шесть: шести шесть
неделя: недель
уменьшать: уменьшает
эффективность: эффективность
прививка: прививок
снижаться: снижается
иммунитет: иммунитет
значительный: значительное
число: число
пропустить: пропустит
серьезный: серьезно
подорвать: подорвет
усилие: усилия усилиям
прекращение: прекращению
вирус: вируса
подчеркнуть: подчеркнули
добавить: добавив
также: также
привести: привести
соседний: соседних
страна: странах
подписываться: подписывайтесь
наш: нашу наши
рассылка: рассылку
загружать: загружайте
приложение: приложение
устройство: устройств
возобновиться: возобновится
боевой: боевые
препятствовать: препятствуют
получить: получили
ранение: ранения
результат: результате
удар: удара
центр: центру
информация: информация
новостной: новостные
анонс: анонсы
журнал: журнал
отчет: отчеты
заседание: заседаниях
аудиовизуальный: аудиовизуальные
материал: материалы
общение: общение
твиттер: твиттер
главное: главные
брифинг: брифингов
стенограмма: стенограммы
комментарий: комментарии
журналист: журналистов
интернет: интернете
фейсбук: фейсбук
вконтакте: вконтакте
контакт: контакты
пользоваться: пользоваться
сайт: сайтом
указатель: указатель
часто: часто
задавать: задаваемые
вопрос: вопросы
остерегаться: остерегайтесь
мошенничество: мошенничества
конфиденциальность: конфиденциальность
условие: условия
пользование: пользования
пожертвование: пожертвования