караван: караван каравана
грудной: грудного грудным грудное грудном грудному
вскармливание: вскармливания вскармливанием вскармливание вскармливании вскармливанию
молдова: молдове молдова молдовы
развенчивать: развенчивает
миф: мифы мифов
помогать: помогает
семья: семьям семей семьи семьей
новость: новости
оон: оон
перейти: перейти
основное: основному
добро: добро
пожаловать: пожаловать
русский: русский
другой: другие другими другим
глобальный: глобальный глобальным
взгляд: взгляд
человеческий: человеческие
судьба: судьбы
поиск: поиск
расширить: расширенный
язык: язык
меню: меню
главный: главная
азия: азия
америка: америка
африка: африка
ближний: ближний
восток: восток
европа: европа
тема: темы теме
гуманитарный: гуманитарная
помощь: помощь
беженец: беженцы
мигрант: мигранты
женщина: женщины женщин
здравоохранение: здравоохранение здравоохранения
климат: климат
окружать: окружающая
среда: среда
культура: культура
образование: образование
международный: международное международного
правый: право права прав
мир: мир миру мире
безопасность: безопасность
генеральный: генеральный генерального
секретарить: секретарь секретаря
человек: человека
цель: цели целям
устойчивый: устойчивого устойчивому
развитие: развития развитие
экономический: экономическое экономическому
подробный: подробнее
интервью: интервью
сюжет: сюжеты
экспресс-новости: экспресс-новости
фоторепортаж: фоторепортажи
пресс-секретарь: пресс-секретарь
выступление: выступления
заявление: заявления
пресса: прессой
официальный: официальные
поездка: поездки
фотография: фотографии
пресс-релиз: пресс-релизы
группа: группа
аккредитация: аккредитации
сми: сми
интернет-трансляция: интернет-трансляция
аудиотека: аудиотека
подписаться: подписаться
воз: воз
продвигать: продвигает
преимущество: преимущества преимуществах
печать: печать
август: августа
ежегодно: ежегодно
все: всему всем
число: числе
республика: республике
отмечаться: отмечается отмечаются
всемирный: всемирная всемирной
неделя: неделя
рамка: рамках
общенациональный: общенациональной
инициатива: инициативы инициатива
расширение: расширению расширения
возможность: возможностей возможность возможности
матерой: матерей
защита: защите
младенец: младенцев младенца
страна: стране
путешествовать: путешествует путешествуя
проект: проект проекты
поддержка: поддержке поддержка поддержку поддержки
организация: организации
житель: жителей
различный: различных
регион: регионов регионе
год: году
проследовать: проследует
северный: северного
город: города
бельцы: бельцы бельцов
кантемир: кантемир
леово: леову
также: также
столица: столицу
кишинев: кишинев
дорога: дороге
быть: будут
организовать: организованы
информационный: информационные
мероприятие: мероприятия мероприятий
который: которых которая которые
участвовать: участвуют
беременная: беременные
мать: матери
член: члены
медицинский: медицинские медицинских медицинскими
работник: работники работников работниками
представитель: представители
правительство: правительства
очень: очень
благодарный: благодарна
получить: получить
информация: информации информация
эксперт: экспертов
вакцинация: вакцинации
пообщаться: пообщаться
мама: мамами мам
сказать: сказала
ольга: ольга
матей: матей
жительница: жительница
прийти: пришла
подготовка: подготовки
роды: родам
вместе: вместе
развенчать: развенчали развенчать
большинство: большинство
связанный: связанных
питание: питанием питании
стать: стало
полезный: полезным
занятие: занятием
добавить: добавила
непосредственный: непосредственная непосредственную
польза: польза пользу
подчеркивать: подчеркивают
обеспечивать: обеспечивает обеспечивающих
хороший: наилучшее
начало: начало
жизнь: жизни
любой: любого любое любом
новорожденный: новорожденного
позитивно: позитивно
влиять: влияя
здоровье: здоровье здоровья
ребенок: дети детей
реж: реже
страдать: страдают
избыточный: избыточным
весомый: весом
ожирение: ожирением
менее: менее
подверженный: подвержены
диабет: диабету
неинфекционный: неинфекционным
заболевание: заболеваниям
поздний: позднем
возраст: возрасте
кормить: кормят кормящие
грудь: грудью
иметь: имеют
меньший: меньший
риск: риск
рак: рака
молочная: молочной
железа: железы
яичник: яичников
приносить: приносит
оказывать: оказывает
благоприятный: благоприятное
воздействие: воздействие
многие: многие
аспект: аспекты
достижение: достижении
целый: целей целом
например: например
оно: оно
содействовать: содействует
укрепление: укреплению
цур: цур
гендерный: гендерному
равенство: равенству
сокращение: сокращению
неравенство: неравенства
расширять: расширяя
способствовать: способствуя способствует способствовать
финансовый: финансовой
независимость: независимости
инклюзивному: инклюзивному
рост: росту
время: время
место: месте
несмотря: несмотря
доказать: доказанные
половина: половины половина
месяц: месяцев
находиться: находятся
исключительно: исключительно
европейский: европейском
один: одни
самый: самых
низкий: низких
показатель: показателей показателях
лишь: лишь
процент: процентов
читать: читайте
планет: планете
шесть: шести
питаться: питаются
молоко: молоком молока
настолько: настолько
наш: нашем нашего нашу наши
важный: важно важные
открыть: открытому
обсуждение: обсуждению обсуждения
вопрос: вопросов вопросы
такой: такие
объединять: объединяют
сообщество: сообщества
лицо: лиц
принимать: принимающих
решение: решения
нормализация: нормализации
поощрение: поощрения поощрение
прилагать: прилагают
усилие: усилия
получать: получали
независимо: независимо
жить: живут
работать: работают работающих
специалист: специалист
клэр: клэр
фарранд: фарранд
душевный: душевные
встреча: встречи
ход: ходе
участник: участники
мочь: могут
прослушать: прослушать
сессия: сессии
посвященныепреимуществам: посвященныепреимуществам
совет: советы
распространить: распространенные
заблуждение: заблуждения
первый: первую
очередь: очередь
это: это
будущее: будущими
медсестра: медсестра
галина: галина
бостан: бостан
рада: рада
видеть: видеть
свое: своих
коллега: коллег
приверженность: приверженность
узнать: узнать
исключительность: исключительности
продолжение: продолжении
новорожденная: новорожденных
плановый: плановой
политик: политика политику
действие: действия
эффективный: эффективную
интеграция: интеграции
включать: включает
принятие: принятие
закон: законов
продление: продление
оплачивать: оплачиваемого
отпуск: отпуска
беременность: беременности
внедрение: внедрение
свод: свода
править: правил
сбыт: сбыта
заменитель: заменителей
регулировать: регулирующего
практик: практики
маркетинг: маркетинга
они: ними
продукт: продуктов
реализация: реализацию
шаг: шагов
успешный: успешному
рекомендовать: рекомендованных
инициировать: инициирует
активизировать: активизирует
этот: эта
служить: служит
связующий: связующим
звено: звеном
население: населением
подписываться: подписывайтесь
рассылка: рассылку
загружать: загружайте
приложение: приложение
мобильный: мобильных
устройство: устройств
баланс: баланс
работа: работой
родитель: родителей
эстония: эстонии
юнисеф: юнисеф
призывать: призывают
поддержать: поддержать
пандемия: пандемия
научить: научила
мыслить: мыслить
по-другому: по-другому
ресурс: ресурсы
партнер: партнеров
новостной: новостные
анонс: анонсы
журнал: журнал
отчет: отчеты
заседание: заседаниях
аудиовизуальный: аудиовизуальные
материал: материалы
общение: общение
твиттер: твиттер
последний: последние
главное: главные
брифинг: брифингов
стенограмма: стенограммы
комментарий: комментарии
журналист: журналистов
интернет: интернете
фейсбук: фейсбук
вконтакте: вконтакте
контакт: контакты
пользоваться: пользоваться
сайт: сайтом
указатель: указатель
часто: часто
задавать: задаваемые
остерегаться: остерегайтесь
мошенничество: мошенничества
конфиденциальность: конфиденциальность
условие: условия
пользование: пользования
пожертвование: пожертвования