брифинг: брифинг брифинге брифингов
глава: главы глава
воз: воз
эбола: эбола
уганда: уганде уганды
дрк: дрк
газ: газа газе газу
приостановка: приостановка
американский: американского американских
финансирование: финансирования финансирование
новость: новости
оон: оон
перейти: перейти перейдя
основное: основному
добро: добро
пожаловать: пожаловать
русский: русский
другой: другие других
глобальный: глобальный глобальному глобального глобальные
взгляд: взгляд
человеческий: человеческие
судьба: судьбы
поиск: поиск
расширить: расширенный
язык: язык
меню: меню
главный: главная
азия: азия
америка: америка
африка: африка африке
ближний: ближний
восток: восток
европа: европа
тема: темы теме
гуманитарный: гуманитарная
помощь: помощь помощи
беженец: беженцы
мигрант: мигранты
женщина: женщины
здравоохранение: здравоохранение здравоохранения
климат: климат
окружать: окружающая
среда: среда среду
культура: культура
образование: образование
международный: международное международная
правый: право права
мир: мир
безопасность: безопасность безопасности
генеральный: генеральный генерального
секретарить: секретарь секретаря
человек: человека человек
цель: цели
устойчивый: устойчивого
развитие: развития развитие
экономический: экономическое
подробный: подробнее
интервью: интервью
сюжет: сюжеты
экспресс-новости: экспресс-новости
фоторепортаж: фоторепортажи
пресс-секретарь: пресс-секретарь
выступление: выступления
заявление: заявления
пресса: прессой
официальный: официальные
поездка: поездки
фотография: фотографии
пресс-релиз: пресс-релизы
группа: группа
аккредитация: аккредитации
сми: сми
интернет-трансляция: интернет-трансляция
аудиотека: аудиотека
подписаться: подписаться
гендиректор: гендиректор
выступать: выступает выступая
женева: женеве
фото: фото
архив: архива
печать: печать
февраль: февраля
дать: данный
момент: момент
подтвердить: подтверждены
девять: девять
случай: случаев
заражение: заражения
лихорадка: лихорадкой
число: числе
летальный: летальный
исход: исход
выявить: выявлены
находиться: находятся
наблюдение: наблюдением
контактировать: контактировавших
заболеть: заболевшими
журналист: журналистов
сообщить: сообщил
директор: директор
всемирный: всемирной всемирная
организация: организации организация
тедрос: тедрос
адханом: адханом
гебрейесус: гебрейесус
оказывать: оказываем
оперативный: оперативную
поддержка: поддержку поддержки
власть: властям
область: области
эпидемнадзора: эпидемнадзора
лабораторный: лабораторного
анализ: анализа
логистика: логистики
профилактика: профилактики профилактике
инфекция: инфекций
инфекционный: инфекционного инфекционных
контроль: контроля
сказать: сказал
кроме: кроме
обеспечивать: обеспечиваем
поставка: поставки поставок
необходимый: необходимого
наш: наших нашу наши
логистический: логистических
центр: центров
найроби: найроби
дубай: дубае
слово: словам
настоящее: настоящее
время: время
существовать: существует существующие
официально: официально
одобрить: одобренных одобрила
вакцина: вакцин вакцины
терапевтический: терапевтических
средство: средств
штамм: штаммов
вирус: вируса
который: которые который
зафиксировать: зафиксированы
мера: мерам мер мере
обеспечение: обеспечению обеспечением
готовность: готовности
принять: принятым
правительство: правительством правительство
предыдущий: предыдущей
вспышка: вспышки
сотрудничество: сотрудничеству
научный: научных
исследование: исследований
смочь: смогла
начать: начать
испытание: испытание
потенциально: потенциально
эффективный: эффективной
новый: новой новый
ответный: ответных
выделить: выделил
миллион: миллиона миллиону
доллар: долларов
резервный: резервного
фонд: фонда
дополнение: дополнение
внести: внесен
ранее: ранее
первоначальный: первоначального
реагирование: реагирования
ситуация: ситуация ситуации
всплеск: всплеску
насилие: насилия
восточный: восточной
частить: части
демократический: демократической
республика: республики
конго: конго
провинция: провинциях
северный: северное
южный: южное
киву: киву
получить: получить
медицинский: медицинские медицинских
услуга: услуги услуг
мочь: могут
треть: трети
нуждаться: нуждающихся
беременная: беременные
добраться: добраться
учреждение: учреждений
безопасный: безопасных
роды: родов
угроза: угроза
распространение: распространения
заболевание: заболеваний
оспа: оспы
обезьяна: обезьян
холера: холеры
возрасти: возросла
раз: разы
больница: больницы
морг: морги
переполнить: переполнены
продолжить: продолжил
некоторые: некоторым
медработник: медработникам
прийтись: пришлось
бежать: бежать
работать: работают работать работаем
круглосуточно: круглосуточно
продолжать: продолжает
место: местах
несмотря: несмотря
отсутствие: отсутствие
предвидеть: предвидя
эскалация: эскалацию
ноябрь: ноября
заблаговременный: заблаговременным
включать: включая
медикамент: медикаменты
топливо: топливо
однако: однако
запас: запасы
заканчиваться: заканчиваются
многие: многие
склад: склады
разграбить: разграблены
начало: начала
действие: действия
режим: режима
прекращение: прекращения прекращение прекращению
огонь: огня
январь: январе
направить: направила
автомашина: автомашин
груз: грузами
оказать: оказала оказать
эвакуация: эвакуации
пациент: пациентов
сопровождать: сопровождающих
лицо: лиц
ответ: ответ
западный: западном
беречь: берегу
предмет: предметы
первый: первой
необходимость: необходимости
местный: местные
читать: читайте
также: также
такой: такое
почему: почему
важный: важна
призывать: призываем
сторона: стороны
обеспечить: обеспечить
полный: полное
соблюдение: соблюдение
освобождение: освобождение
заложник: заложников
заявить: заявил
сша: сша
напомнить: напомнил
значительный: значительная
часть: часть
чрезвычайный: чрезвычайные чрезвычайного
судан: судане
страна: странах
осуществляться: осуществляется
счет: счет
соединить: соединенных соединенные
штат: штатов штаты
говорить: говорили
сожалеть: сожалеем
намерен: намерены
выйти: выйти
рада: рады
возможность: возможности
конструктивный: конструктивного
диалог: диалога
предпринимать: предпринимает
связанный: связаны
членство: членством
серьезный: серьезное
воздействие: воздействие
состояние: состояние
план: плана
президент: президента
оказание: оказанию
связь: связи
спид: спидом
привести: привела
лечение: лечению
тестирование: тестированию
вич: вич
внезапный: внезапная
деятельность: деятельности
ряд: ряда
институт: институтов
влиять: влияют
усилие: усилия
искоренение: искоренению
полиомиелит: полиомиелита
противодействие: противодействие
рапространению: рапространению
просить: просим
рассмотреть: рассмотреть
вопрос: вопрос вопросы
продолжение: продолжении
крайний: крайней
тот: тех
пора: пор
быть: будут
найти: найдены
альтернативный: альтернативные
решение: решения
подписываться: подписывайтесь
рассылка: рассылку
загружать: загружайте
приложение: приложение
мобильный: мобильных
устройство: устройств
комиссия: комиссия
необходимо: необходимо
усовершенствовать: усовершенствовать
система: систему
предупреждение: предупреждения
пандемия: пандемий
революционный: революционный
тест: тест
туберкулез: туберкулез
государственный: государственные
расход: расходы
снижаться: снижаются
ресурс: ресурсы
информация: информация
партнер: партнеров
новостной: новостные
анонс: анонсы
журнал: журнал
отчет: отчеты
заседание: заседаниях
аудиовизуальный: аудиовизуальные
материал: материалы
общение: общение
твиттер: твиттер
последний: последние
главное: главные
стенограмма: стенограммы
комментарий: комментарии
интернет: интернете
фейсбук: фейсбук
вконтакте: вконтакте
контакт: контакты
пользоваться: пользоваться
сайт: сайтом
указатель: указатель
часто: часто
задавать: задаваемые
остерегаться: остерегайтесь
мошенничество: мошенничества
конфиденциальность: конфиденциальность
условие: условия
пользование: пользования
пожертвование: пожертвования