начало: начала
полномасштабный: полномасштабной полномасштабное полномасштабного
война: войны
воз: воз
зарегистрировать: зарегистрировала
нападение: нападений нападениям нападение нападения
объект: объекты
здравоохранение: здравоохранения здравоохранение
украина: украины украина украине
новость: новости
оон: оон
перейти: перейти
основное: основному
добро: добро
пожаловать: пожаловать
русский: русский
другой: другие другими
глобальный: глобальный
взгляд: взгляд
человеческий: человеческие
судьба: судьбы
поиск: поиск
расширить: расширенный
язык: язык
меню: меню
главный: главная
азия: азия
америка: америка
африка: африка
ближний: ближний
восток: восток
европа: европа
тема: темы теме
гуманитарный: гуманитарная гуманитарной гуманитарных гуманитарные
помощь: помощь помощи
беженец: беженцы
мигрант: мигранты
женщина: женщины
климат: климат
окружать: окружающая
среда: среда
культура: культура
образование: образование
международный: международное
правый: право права
мир: мир миру
безопасность: безопасность
генеральный: генеральный генерального
секретарить: секретарь секретаря
человек: человека человек
цель: цели
устойчивый: устойчивого
развитие: развития развитие
экономический: экономическое
подробный: подробнее
интервью: интервью
сюжет: сюжеты
экспресс-новости: экспресс-новости
фоторепортаж: фоторепортажи
пресс-секретарь: пресс-секретарь
выступление: выступления
заявление: заявления
пресса: прессой
официальный: официальные
поездка: поездки
фотография: фотографии
пресс-релиз: пресс-релизы
группа: группа
аккредитация: аккредитации
сми: сми
интернет-трансляция: интернет-трансляция
аудиотека: аудиотека
подписаться: подписаться
система: системы система системе
число: числе число
машина: машины машин
скорый: скорой
часто: часто
попадать: попадают
обстрел: обстрелы обстрелов
печать: печать
август: августа
всемирный: всемирный всемирной всемирная
деть: день
организация: организации
сообщить: сообщили
февраль: февраля
год: года год году
начаться: началось
вторжение: вторжение вторжения
россия: россии россия россию
зафиксировать: зафиксировано
это: это
сам: самое
большой: большое
подобный: подобных
атака: атак атаки
который: которое которая
когда-либо: когда-либо
регистрировать: регистрировала
чрезвычайный: чрезвычайных
ситуация: ситуациях
все: всему
медицинский: медицинские медицинской медицинских медицинского медицинскую
учреждение: учреждения
процент: процентов
затрагивать: затрагивали
значительный: значительная значительной
часть: часть
связанный: связана
использование: использованием
тяжелый: тяжелых
вооружение: вооружений
значительно: значительно
усилиться: усилились
декабрь: декабря
происходить: происходят происходит
ежедневно: ежедневно
кроме: кроме
отмечать: отмечают
средний: среднем
получать: получали получают
повреждение: повреждения
уничтожаться: уничтожались
результат: результате
население: населения
проживать: проживающего
вблизи: вблизи
линия: линии
фронт: фронта
доступ: доступ доступа
степень: степени
ограничить: ограничен
медперсонал: медперсонал
двойной: двойные двойных
жертва: жертвами жертвой
также: также
становиться: становятся
работник: работники работник работников работниками
сообщать: сообщают
наблюдать: наблюдаем
сказать: сказал
представитель: представитель
территория: территории
ярно: ярно
хабихт: хабихт
рассказать: рассказал
эмануэль: эмануэль
бруни: бруни
сотрудник: сотрудников сотрудники
страна: стране страны
медработник: медработники
гибнуть: гибнут
ранение: ранения
повторный: повторных
удар: ударов удара
место: местам месту
подвергнуться: подвергшимся
частность: частности
вспомнить: вспомнил
случай: случай случая
произойти: произошедший произошла
одесса: одессе
семь: семь
месяц: месяцев
назад: назад
первый: первой
неотложный: неотложной
быстро: быстро
бежать: бежал
обращать: обращая
внимание: внимания
сирена: сирены
предупреждение: предупреждения
дух: дух
печальный: печальная
история: история
разбить: разбила
сердце: сердце
молодая: молодой
стать: стал
второе: второго
тот: тому
прошлый: прошлом
смерть: смерти
пациент: пациентов
первое: первые
половина: половиной
погибнуть: погибло
общий: общей
сложность: сложности
уровень: уровень
травма: травм травмам
превысить: превысил
показатель: показатели
получить: получили
целый: целом
каждый: каждое каждый
четвертый: четвертое
привести: привело
гражданский: гражданской
инфраструктура: инфраструктуры
ранний: раньше
терять: теряем
коллега: коллег
медсестра: медсестер
врач: врачей
фельдшер: фельдшеров
пострадать: пострадало
горазд: гораздо
медиков: медиков
дать: данным
служба: служб
быстрый: быстрого
реагирование: реагирования
раз: раза
чаща: чаще
страдать: страдают
сравнение: сравнению
распределить: распределила
тонна: тонн
товар: товаров
оборудование: оборудования
назначение: назначения
включать: включая
лекарство: лекарства
генератор: генераторы
несколько: нескольких
регион: регионах
миллион: миллионов миллиона
сосредоточить: сосредоточим
наш: наши нашу
основной: основные
усилие: усилия
потребность: потребностях
украинский: украинская
продолжать: продолжает продолжают
доказывать: доказывать
устойчивость: устойчивость
оставаться: остается
функциональный: функциональной
район: районах
находиться: находящихся
контроль: контролем
правительство: правительства
несмотря: несмотря
непрекращающийся: непрекращающиеся
орган: органы
реагировать: реагировать
проблема: проблемы
вносить: вносят
свой: свой
вклад: вклад
заполнение: заполнение
существовать: существующих
пробел: пробелов
улучшение: улучшение
прифронтовой: прифронтовых
настоящее: настоящие
герой: герои
заявить: заявил
продолжаться: продолжающиеся
снова: снова
проявлять: проявляют
хороший: наилучшей
сторона: стороны
отдавать: отдаем
дань: дань
уважение: уважения
обещать: обещаем
поддержка: поддержкой
заключить: заключил
подписываться: подписывайтесь
рассылка: рассылку
загружать: загружайте
приложение: приложение
мобильный: мобильных
устройство: устройств
вопрос: вопрос вопросы
прийти: придет
второй: вторая
волна: волна
смочь: сможем
подготовиться: подготовиться
ассамблея: ассамблея
призвать: призвала
прекратить: прекратить
больница: больницы
эпидемия: эпидемии
являться: является
неизбежность: неизбежностью
ресурс: ресурсы
информация: информация
партнер: партнеров
новостной: новостные
анонс: анонсы
журнал: журнал
отчет: отчеты
заседание: заседаниях
аудиовизуальный: аудиовизуальные
материал: материалы
общение: общение
твиттер: твиттер
последний: последние
главное: главные
брифинг: брифингов
стенограмма: стенограммы
комментарий: комментарии
журналист: журналистов
интернет: интернете
фейсбук: фейсбук
вконтакте: вконтакте
контакт: контакты
пользоваться: пользоваться
сайт: сайтом
указатель: указатель
задавать: задаваемые
остерегаться: остерегайтесь
мошенничество: мошенничества
конфиденциальность: конфиденциальность
условие: условия
пользование: пользования
пожертвование: пожертвования