оон: оон
сожалеть: сожалеют сожалеет
выход: выходе выходу выхода
сша: сша
воз: воз
парижский: парижского парижским парижское парижском
соглашение: соглашения соглашением соглашение соглашении
климат: климату климат климатом
новость: новости
перейти: перейти
основное: основному
добро: добро
пожаловать: пожаловать
русский: русский
другой: другие
глобальный: глобальный глобального глобальных
взгляд: взгляд
человеческий: человеческие
судьба: судьбы
поиск: поиск
расширить: расширенный
язык: язык
меню: меню
главный: главная главный
азия: азия
америка: америка америки
африка: африка
ближний: ближний
восток: восток
европа: европа
тема: темы теме
гуманитарный: гуманитарная гуманитарных гуманитарной
помощь: помощь
беженец: беженцы
мигрант: мигранты
женщина: женщины
здравоохранение: здравоохранение здравоохранения
окружать: окружающая
среда: среда
культура: культура
образование: образование
международный: международное международной
правый: право права
мир: мир
безопасность: безопасность
генеральный: генеральный генерального
секретарить: секретарь секретаря
человек: человека люди
цель: цели
устойчивый: устойчивого устойчивым
развитие: развития развитие
экономический: экономическое экономических экономическим
подробный: подробнее
интервью: интервью
сюжет: сюжеты
экспресс-новости: экспресс-новости
фоторепортаж: фоторепортажи
пресс-секретарь: пресс-секретарь
выступление: выступления
заявление: заявления
пресса: прессой
официальный: официальные
поездка: поездки
фотография: фотографии
пресс-релиз: пресс-релизы
группа: группа
аккредитация: аккредитации
сми: сми
интернет-трансляция: интернет-трансляция
аудиотека: аудиотека
подписаться: подписаться
фото: фото
оонл: оонл
фелипе: фелипе
штаб-квартира: штаб-квартира
нью-йорк: нью-йорке
печать: печать
январь: января январе
вторник: вторник
учреждение: учреждения
прокомментировать: прокомментировали прокомментировала
распоряжение: распоряжения
президент: президента президент
дональд: дональда дональд
трамп: трампа трамп
прекращение: прекращении
членство: членства
соединить: соединенных соединенные
штат: штатов штаты
всемирный: всемирной
организация: организации
представитель: представители представитель
рассказать: рассказали
огромный: огромных
потенциальный: потенциальных
негативный: негативных
последствие: последствиях
этот: этих
решение: решений решение
общественный: общественного
усилие: усилий
сдерживание: сдерживанию
потепление: потепления
объявить: объявили
намерение: намерении
выйти: выйти
надеяться: надеемся
пересмотреть: пересмотрят
свое: свое своего
заявить: заявил заявив заявила заявили
тарик: тарик
ясаревич: ясаревич
несколько: несколько
часы: часов
новоизбранный: новоизбранный
подписать: подписал
белый: белом
дом: доме
соответствующий: соответствующий
исполнительный: исполнительный
указ: указ
присоединиться: присоединились
год: году года год годом
оба: обе
палата: палаты
конгресс: конгресса
принять: приняли
совместный: совместную
резолюция: резолюцию
предпринять: предпринял
шаг: шаги шаг
время: время
первое: первого
срок: срока
это: это
отменить: отменено
администрация: администрацией администрацию
байдена: байдена
отвечать: отвечая
вопрос: вопросы вопрос вопросов вопросах
журналист: журналистов
женева: женеве
подчеркнуть: подчеркнул подчеркнула
играть: играет
ключевой: ключевую
роль: роль
защита: защите
здоровье: здоровья
житель: жителей
планет: планеты
включать: включая
американец: американцев
устранять: устраняет
коренной: коренные
причина: причины
заболевание: заболеваний
создавать: создает
эффективный: эффективные
система: системы системе
также: также
выявлять: выявляет
чрезвычайный: чрезвычайные
ситуация: ситуации
область: области
предотвращать: предотвращает
реагировать: реагирует
число: числе
место: местах места мест
служба: службы
попасть: попасть
мочь: могут
отметить: отметил отметила отметив отметили
полный: полной
оценка: оценки
необходимо: необходимо
проанализировать: проанализировать
подтвердить: подтвердил
крупный: крупнейшим
донор: донором
обеспечивать: обеспечивая
процент: процентов
бюджет: бюджета
агентство: агентства
управление: управления
координация: координации
укгв: укгв
йенс: йенс
лэрке: лэрке
важность: важность
жить: живут
долгий: дольше
чувствовать: чувствуют
здоровый: здоровыми
счастливый: счастливыми
многий: многом
присутствовать: присутствует
добраться: добраться
сказать: сказал
упомянуть: упомянув
такой: такие
газ: газа
йемен: йемен
афганистан: афганистан
судан: судан
незаменимый: незаменимая
часть: часть
добавить: добавил добавили
климатический: климатический климатические
шок: шок
метеорологический: метеорологической
вмо: вмо
клэр: клэр
нуллис: нуллис
слово: словам
возвращать: возвращает
политик: политике
президентский: президентского
завершиться: завершившегося
необходимость: необходимость
соблюдение: соблюдения
все: всеми
страна: странами страна страны
очевидный: очевидна
особенно: особенно
учитывать: учитывая
стать: стал
самый: самым
жаркий: жарким
история: истории
примерный: примерно
теплый: теплее
доиндустриальный: доиндустриальной
эпоха: эпохи
вызов: вызов
наш: нашего нашу наши
временить: времени
представительница: представительница
напомнить: напомнила
недавний: недавних
разрушительный: разрушительных
смертоносный: смертоносных
лесной: лесных
пожар: пожарах
лос-анджелес: лос-анджелесе
основной: основная
потеря: потерь
катаклизм: катаклизмов
катастрофа: катастроф катастрофы
связанный: связанных
прийтись: пришлась
именно: именно
пережить: пережила
погодный: погодные
каждый: каждая
который: которых который
привести: привела
ущерб: ущербу ущерба
миллиард: миллиарда
доллар: долларов
общий: общая
сумма: сумма
результат: результате
инцидент: инцидентов
превышать: превышает
триллион: триллиона
дать: данным
понедельник: понедельник
пресс-служба: пресс-службе
трансформация: трансформация
предусмотренный: предусмотренная
начаться: началась
революция: революция
возобновлять: возобновляемой
энергия: энергии
предлагать: предлагает
возможность: возможности
создание: создания
рабочий: рабочих рабочие
процветание: процветания
уверить: уверен
город: города
предприятие: предприятия
продолжить: продолжат
демонстрировать: демонстрировать
видение: видение
лидерство: лидерство
работать: работая
низкоуглеродным: низкоуглеродным
рост: ростом
создать: создаст
качественный: качественные
век: веке
крайне: крайне
важный: важно
оставаться: оставались
лидер: лидером
экология: экологии
подписываться: подписывайтесь
рассылка: рассылку
загружать: загружайте
приложение: приложение
мобильный: мобильных
устройство: устройств
глава: глава
поздравить: поздравил
победа: победой
выбор: выборах
приветствовать: приветствовал
готовность: готовность
вашингтон: вашингтона
вернуться: вернуться
участие: участию
генассамблея: генассамблее
намерен: намерен
бороться: бороться
несправедливость: несправедливостью
торговля: торговли
ресурс: ресурсы
информация: информация
партнер: партнеров
новостной: новостные
анонс: анонсы
журнал: журнал
отчет: отчеты
заседание: заседаниях
аудиовизуальный: аудиовизуальные
материал: материалы
общение: общение
твиттер: твиттер
последний: последние
главное: главные
брифинг: брифингов
стенограмма: стенограммы
комментарий: комментарии
интернет: интернете
фейсбук: фейсбук
вконтакте: вконтакте
контакт: контакты
пользоваться: пользоваться
сайт: сайтом
указатель: указатель
часто: часто
задавать: задаваемые
остерегаться: остерегайтесь
мошенничество: мошенничества
конфиденциальность: конфиденциальность
условие: условия
пользование: пользования
пожертвование: пожертвования