вспышка: вспышка вспышки вспышкам вспышку
оспа: оспы оспе оспа оспой
обезьяна: обезьян
угрожать: угрожает
миллион: миллионам миллиона млн
вынудить: вынужденных вынужденным вынужденные
переселенец: переселенцев переселенцы
дрк: дрк
новость: новости
оон: оон
перейти: перейти
основное: основному
добро: добро
пожаловать: пожаловать
русский: русский
другой: другие других
глобальный: глобальный глобальном
взгляд: взгляд
человеческий: человеческие
судьба: судьбы
поиск: поиск
расширить: расширенный
язык: язык языках
меню: меню
главный: главная
азия: азия
америка: америка
африка: африка африки африке
ближний: ближний
восток: восток
европа: европа
тема: темы теме
гуманитарный: гуманитарная гуманитарной
помощь: помощь помощи
беженец: беженцы беженцев
мигрант: мигранты мигрантов
женщина: женщины
здравоохранение: здравоохранение здравоохранения
климат: климат
окружать: окружающая
среда: среда среду
культура: культура
образование: образование
международный: международное международной международная
правый: право права прав
мир: мир миру
безопасность: безопасность безопасностью
генеральный: генеральный генерального
секретарить: секретарь секретаря
человек: человека человеку
цель: цели
устойчивый: устойчивого
развитие: развития развитие
экономический: экономическое
подробный: подробнее
интервью: интервью
сюжет: сюжеты
экспресс-новости: экспресс-новости
фоторепортаж: фоторепортажи
пресс-секретарь: пресс-секретарь
выступление: выступления
заявление: заявления
пресса: прессой
официальный: официальные
поездка: поездки
фотография: фотографии
пресс-релиз: пресс-релизы
группа: группа
аккредитация: аккредитации
сми: сми
интернет-трансляция: интернет-трансляция
аудиотека: аудиотека
подписаться: подписаться
юнисефджбенекире: юнисефджбенекире
распространение: распространение распространения распространению
информация: информации информация
житель: жителей
провинция: провинции провинциях
южный: южное южной
киву: киву
конго: конго
печать: печать
август: августа
всемирный: всемирной
организация: организации организация
воз: воз
потребоваться: потребуется
доллар: долларов
реализация: реализации реализация
мера: мер мере меры
сдерживание: сдерживанию сдерживания
устранение: устранению
период: период
сентябрь: сентября
текущий: текущего
год: года
февраль: февраль
средство: средства средств
быть: будут
использовать: использованы
мероприятие: мероприятий мероприятия
изложить: изложенных
стратегический: стратегическом
план: плане план
обеспечение: обеспечения обеспечению
готовность: готовности
реагирование: реагирования
который: который которых которые
опубликовать: опубликован
понедельник: понедельник
представлять: представляет представлять
себя: собой
всеобъемлющий: всеобъемлющую
рамочный: рамочную
программа: программу программ
разработать: разработанную
качество: качестве
руководство: руководства
борьба: борьбы
инфекция: инфекцией
все: всему
читать: читайте
также: также
юнисеф: юнисеф
результат: результате
страдать: страдают
ребенок: дети
финансовый: финансовые
необходимый: необходимы необходимые необходимых
координация: координации
усилие: усилий усилия
предотвращение: предотвращению
оказание: оказанию
технический: технической
местный: местным местных местной
орган: органам органами
иной: иным
партнер: партнерам партнеры партнеров
операционный: операционной
деятельность: деятельности
доставка: доставки
предмет: предметов
медицинский: медицинского медицинских медицинской
назначение: назначения
риск: риски риск
управление: управлении
дело: делам
увкб: увкб
предупреждать: предупреждают
дополнительный: дополнительных
крайне: крайне
серьезный: серьезную
опасность: опасность
переместить: перемещенных
лицо: лиц
демократический: демократической
республика: республике
страна: странах страны странам
выявить: выявлено
меньший: меньшей
предполагать: предполагаемых предполагаемые
случай: случая случаи случаев
заболевание: заболевания заболеваний
подтвердить: подтвержденные подтверждены
зарегистрировать: зарегистрированы зарегистрировано
руанда: руанде
дать: данным
сегодняшний: сегодняшний
деть: день
тысяча: тысяч
смерть: смертей
граничить: граничащих
новый: новым
штамм: штаммом
кладой: кладой
вирус: вируса вирус
подозреваться: подозреваются
пострадать: пострадавших
конфликт: конфликта
проживать: проживает
большинство: большинство
внутренний: внутренне
этот: этих
район: районах
усугубить: усугубить
тяжелый: тяжелую
ситуация: ситуацию ситуации ситуация
вызвать: вызванную
насилие: насилием
перемещение: перемещением
нарушение: нарушениями
отсутствие: отсутствием отсутствие
многие: многих многие
оставаться: остается
огромный: огромной
проблема: проблемой
жить: живут
переполнить: переполненных
убежище: убежищах
плохой: плохим
водоснабжение: водоснабжением
санитария: санитарией
недостаточный: недостаточным
доступ: доступом
услуга: услугам
нуждаться: нуждающиеся нуждаются
оказаться: оказались
отрезать: отрезаны
хватать: хватает
место: места местах
изоляция: изоляции
появление: появлении
симптом: симптомов
некоторые: некоторые
заболеть: заболевшие
ночевать: ночуют
открыть: открытым
небо: небом
негативный: негативно
сказываться: сказывается
перспектива: перспективах
выздоровление: выздоровления
кроме: кроме
восстановление: восстановления
важный: важно важной
сбалансированный: сбалансированное
питание: питание
недоступный: недоступное
оперативный: оперативное
тестирование: тестирование
присутствие: присутствие
иметь: имеет
решающий: решающее
значение: значение
восточный: восточной
частить: части
прямая: прямых
маршрут: маршрутов
препятствовать: препятствуют
осуществление: осуществлению
поддержка: поддержка поддержке
вместе: вместе
расширять: расширяют
доступность: доступность
мытье: мытья
рука: рук
лагерь: лагерях
транзитный: транзитных
центр: центрах
усиливать: усиливают
система: системы
возможный: возможным
начать: начаты
община: общин
однако: однако
работник: работников
вновь: вновь
призвать: призвали призвав
полный: полному
вовлечение: вовлечению
чрезвычайный: чрезвычайную
область: области
общественный: общественного
подписываться: подписывайтесь
наш: нашу наши
рассылка: рассылку
загружать: загружайте
приложение: приложение
мобильный: мобильных
устройство: устройств
здоровье: здоровье
помогать: помогает
выявлять: выявлять
предотвращать: предотвращать
расти: растет
число: число
передаваться: передающихся
животное: животных
запросить: запросил
остановить: остановить
выделить: выделить
подготовка: подготовку
всплеск: всплеску всплеска
заболеваемость: заболеваемости
часть: частях
африканский: африканского
континент: континента
увеличить: увеличило
заражение: заражения
критически: критически
преддверие: преддверии
ожидать: ожидаемого
сообщить: сообщила
миграция: миграции
мом: мом
финансирование: финансирования
ответный: ответных
ресурс: ресурсы
новостной: новостные
анонс: анонсы
журнал: журнал
отчет: отчеты
заседание: заседаниях
аудиовизуальный: аудиовизуальные
материал: материалы
общение: общение
твиттер: твиттер
последний: последние
главное: главные
брифинг: брифингов
стенограмма: стенограммы
комментарий: комментарии
журналист: журналистов
интернет: интернете
фейсбук: фейсбук
вконтакте: вконтакте
контакт: контакты
пользоваться: пользоваться
сайт: сайтом
указатель: указатель
часто: часто
задавать: задаваемые
вопрос: вопросы
остерегаться: остерегайтесь
мошенничество: мошенничества
конфиденциальность: конфиденциальность
условие: условия
пользование: пользования
пожертвование: пожертвования