сезон: сезон сезона
респираторный: респираторных респираторными респираторным
инфекция: инфекций
воз: воз
предлагать: предлагает предлагают
пять: пять
мера: мер меры мерах
предосторожность: предосторожности
новость: новости
оон: оон
перейти: перейти
основное: основному
добро: добро
пожаловать: пожаловать
русский: русский
другой: другие другими другим
глобальный: глобальный глобального
взгляд: взгляд
человеческий: человеческие
судьба: судьбы
поиск: поиск
расширить: расширенный
язык: язык
меню: меню
главный: главная
азия: азия азии
америка: америка
африка: африка
ближний: ближний
восток: восток
европа: европа европы европе
тема: темы теме
гуманитарный: гуманитарная
помощь: помощь
беженец: беженцы
мигрант: мигранты
женщина: женщины женщин
здравоохранение: здравоохранение здравоохранения
климат: климат
окружать: окружающая окружающих
среда: среда среду
культура: культура
образование: образование
международный: международное
правый: право права
мир: мир
безопасность: безопасность
генеральный: генеральный генерального
секретарить: секретарь секретаря
человек: человека людям человек людей человеку
цель: цели
устойчивый: устойчивого
развитие: развития развитие
экономический: экономическое
подробный: подробнее
интервью: интервью
сюжет: сюжеты
экспресс-новости: экспресс-новости
фоторепортаж: фоторепортажи
пресс-секретарь: пресс-секретарь
выступление: выступления
заявление: заявления
пресса: прессой
официальный: официальные
поездка: поездки
фотография: фотографии
пресс-релиз: пресс-релизы
группа: группа групп группы группу
аккредитация: аккредитации
сми: сми
интернет-трансляция: интернет-трансляция
аудиотека: аудиотека
подписаться: подписаться
возх: возх
мостафа: мостафа
все: всем
представитель: представителям
уязвимый: уязвимых уязвимые уязвимым
население: населения населением
привиться: привиться
печать: печать
октябрь: октября
недавно: недавно
стать: ставший стать
причина: причиной
беспрецедентный: беспрецедентного
свое: своим свое
масштаб: масштабам
кризис: кризиса
войти: вошел
наш: нашу нашей наши
повседневный: повседневную повседневной
жизнь: жизнь жизни
наряд: наряду
грипп: гриппом гриппа гриппу грипп
вирус: вирусами вирусов вирусам
такой: таким такая
образ: образом
направить: направленные направлена
защита: защиту защиты защите
должен: должны
часть: частью
никто: никто
знать: знает знать
сам: самих
европейский: европейском европейского
бюро: бюро
всемирный: всемирной
организация: организации
ерб: ерб
дать: дали данным
старт: старт
кампания: кампании кампания кампанию
девиз: девизом
какой: какие
риск: риски риска риск рисках риске
угрожать: угрожают угрожающие угрожает угрожающем
эксперт: эксперты
особенно: особенно
категория: категорий
оценить: оценить
принять: принять
простой: простые
прежде: прежде
предполагать: предполагает
действие: действия
индивидуальный: индивидуальном
уровень: уровне
подчеркиваться: подчеркивается
орган: органы органам
играть: играют
важный: важную важно
роль: роль
число: числе
путем: путем
своевременный: своевременного
предоставление: предоставления
информация: информации информация
рекомендация: рекомендаций рекомендации
здоровье: здоровья здоровье
центральный: центральная центральной
директор: директор
ханс: ханс
клюге: клюге
сообщить: сообщил сообщили
сегодня: сегодня
страна: странах
по-прежнему: по-прежнему
наблюдаться: наблюдается
смерть: смертей
год: год года году
сезонный: сезонного
составлять: составляет
примерный: примерно
процент: процентов
бременить: бремени
подавлять: подавляющее
большинство: большинство
этот: этих
предотвратить: предотвратить
сказать: сказал
добавить: добавив
наиболее: наиболее
защитить: защищены защитить
вакцина: вакциной вакцины
который: которая которые
доказать: доказано
предотвращать: предотвращает
болезнь: болезнь болезни
тяжелый: тяжелые тяжелой тяжелого
исход: исходы
день: дней
сентябрь: сентября
регион: регионе
случай: случаев
заболевание: заболевания заболеваниями заболеваний
кипр: кипра
молдова: молдовы
ирландия: ирландии
россия: россии
цифра: цифры
высокий: выше
любой: любом любых
друг: другом
скорый: скорее
занизить: занижены
отражать: отражают отражает
реальный: реальную
картина: картину
говориться: говорится
сообщение: сообщении сообщений
иметься: имеющимся
начало: начала
вспышка: вспышки
конец: конце
убить: убил
семь: семи
миллион: миллионов миллиона
зарегистрировать: зарегистрировано
сша: сша
бразилия: бразилии
индий: индии
наступление: наступлением
осенне-зимнего: осенне-зимнего
активизироваться: активизировалась
циркуляция: циркуляция
каждый: каждому
однако: однако
некоторые: некоторых
например: например
старший: старшего
возраст: возраста
беременная: беременных
ослабить: ослабленным
иммунитет: иммунитетом
хронический: хроническими
мочь: могут можете
протекать: протекать
очень: очень
форма: форме
относиться: относитесь
один: одной
необходимо: необходимо
позаботиться: позаботиться
помочь: помогут
это: это
сделать: сделать
во-первых: во-первых
рекомендоваться: рекомендуется
прививка: прививку
во-вторых: во-вторых
оставаться: оставаться
дома: дома
плохой: плохом
самочувствие: самочувствии
в-третьих: в-третьих
надевать: надевать
маска: маску
место: местах
скопление: скопления
в-четвертых: в-четвертых
соблюдать: соблюдать
чистота: чистоту
рука: рук
в-пятых: в-пятых
проветривать: проветривать
помещение: помещения
болеть: болели
делать: делали делать
входить: входите
пройти: пройти
вакцинация: вакцинацию
настоятельно: настоятельно
рекомендовать: рекомендует
предложить: предложена
возможность: возможность
также: также
носить: носить
людный: людных
повышенный: повышенный
течение: течения
заражение: заражении
концепция: концепция
начинать: начинает
новый: новую
переломный: переломный
момент: момент
этап: этапе
переход: перехода
острый: острой
фаза: фазы
чрезвычайный: чрезвычайной
ситуация: ситуации
связанный: связанной
статус: статусу
постоянный: постоянной
угроза: угрозы
урок: уроки
извлечь: извлеченные
общество: обществом общества
профилактика: профилактику
призвать: призвана призваны
нормальный: нормальной
призывать: призываем призывая
фактор: факторы
понять: понять
способность: способность
осознать: осознанный
выбор: выбор
интерес: интересах
проводить: проводим
лозунг: лозунгом
говорить: говорит
кристиан: кристиана
салви: салви
региональный: региональный
советник: советник
информирование: информированию
взаимодействие: взаимодействию
противодействие: противодействию
инфодемии: инфодемии
беречь: беречь
стимулировать: стимулирует
упреждающий: упреждающие
поощрять: поощряет
солидарность: солидарность
ответственность: ответственность ответственности
общий: общее общей
деть: дело
распространение: распространение
адресовать: адресованных
конкретный: конкретным
подгруппа: подгруппам
тезис: тезисов
напоминать: напоминать
хэштег: хэштег
подчеркивать: подчеркивает
одновременно: одновременно
решение: решения
принимать: принимают принимать
самостоятельно: самостоятельно
рамка: рамках
ключевой: ключевая
отводиться: отводится
государственный: государственным
именно: именно
обеспечить: обеспечить
информированный: информированные
самый: самых
член: членов
подписываться: подписывайтесь
рассылка: рассылку
загружать: загружайте
приложение: приложение
мобильный: мобильных
устройство: устройств
получить: получить
заразиться: заразиться
коронавирус: коронавирусом
смешивать: смешивать
фон: фоне
пандемия: пандемии
ресурс: ресурсы
партнер: партнеров
новостной: новостные
анонс: анонсы
журнал: журнал
отчет: отчеты
заседание: заседаниях
аудиовизуальный: аудиовизуальные
материал: материалы
общение: общение
твиттер: твиттер
последний: последние
главное: главные
брифинг: брифингов
стенограмма: стенограммы
комментарий: комментарии
журналист: журналистов
интернет: интернете
фейсбук: фейсбук
вконтакте: вконтакте
контакт: контакты
пользоваться: пользоваться
сайт: сайтом
указатель: указатель
часто: часто
задавать: задаваемые
вопрос: вопросы
остерегаться: остерегайтесь
мошенничество: мошенничества
конфиденциальность: конфиденциальность
условие: условия
пользование: пользования
пожертвование: пожертвования