газ: газа газе газы газу
тысяча: тысяч тысячи
ребенок: детей дети ребенка
вакцинировать: вакцинированы вакцинированных
полиомиелит: полиомиелита
новость: новости
оон: оон
перейти: перейти
основное: основному
добро: добро
пожаловать: пожаловать
русский: русский
другой: другие других другими
глобальный: глобальный
взгляд: взгляд
человеческий: человеческие
судьба: судьбы
поиск: поиск
расширить: расширенный
язык: язык
меню: меню
главный: главная
азия: азия
америка: америка
африка: африка
ближний: ближний
восток: восток
европа: европа
тема: темы теме
гуманитарный: гуманитарная гуманитарных гуманитарными гуманитарной
помощь: помощь помощи
беженец: беженцы
мигрант: мигранты
женщина: женщины
здравоохранение: здравоохранение здравоохранения
климат: климат
окружать: окружающая
среда: среда
культура: культура
образование: образование
международный: международное международные
правый: право права
мир: мир
безопасность: безопасность безопасности
генеральный: генеральный генерального
секретарить: секретарь секретаря
человек: человека людей человек
цель: цели
устойчивый: устойчивого
развитие: развития развитие
экономический: экономическое
подробный: подробнее
интервью: интервью
сюжет: сюжеты
экспресс-новости: экспресс-новости
фоторепортаж: фоторепортажи
пресс-секретарь: пресс-секретарь
выступление: выступления
заявление: заявления
пресса: прессой
официальный: официальные
поездка: поездки
фотография: фотографии
пресс-релиз: пресс-релизы
группа: группа
аккредитация: аккредитации
сми: сми
интернет-трансляция: интернет-трансляция
аудиотека: аудиотека
подписаться: подписаться
бапор: бапор
получать: получают
вакцина: вакцины
печать: печать
сентябрь: сентября
агентство: агентства
оказание: оказанию
палестинец: палестинцам
сообщать: сообщают
первый: первый
деть: день дело
кампания: кампании кампания кампанию
вакцинация: вакцинации вакцинацию вакцинация
юг: юге
прививка: прививки
получить: получили получить
партнер: партнеры партнерами партнеров
сектор: секторе
продолжить: продолжат
максимально: максимально
возможный: возможного
число: числа
южный: южных южной
район: районах
время: время
согласовать: согласованных
пауза: пауз
прежде: прежде
переместиться: переместиться
север: север севере
разрушить: разрушенного
война: войной войны
анклав: анклава анклав
добавить: добавили
семья: семей
посетить: посетили
медицинский: медицинские медицинских медицинского медицинскому
центр: центры центрах центру
привить: привиты привить
хан-юнисе: хан-юнисе
рафахе: рафахе
населенный: населенных
пункт: пунктах
ранее: ранее
напомнить: напомним
этап: этап этапа
масштабный: масштабной
успешный: успешно
провести: проведен
центральный: центральных центральной
возраст: возрасте
год: лет года
защита: защиту защиты
сегодняшний: сегодняшний
совокупный: совокупный
показатель: показатель
составлять: составляет
необходимо: необходимо
общий: общей
сложность: сложности
суббота: субботе
планироваться: планируется
проводиться: проводиться проводится
школа: школах
некоторые: некоторых
случай: случаях
медик: медики
быть: будут
обходить: обходить
место: места
проживание: проживания
никто: никто
остаться: остался оставшиеся
борт: бортом
проведение: проведение
третье: третьего
последний: последнего последние
должен: должно
начаться: начаться
понедельник: понедельник
продлиться: продлиться
день: дня
весь: вся
повториться: повторится
четыре: четыре
неделя: недели неделя
второй: вторую
доза: дозу
препарат: препарата
министерство: министерством
палестина: палестины
сотрудничество: сотрудничестве
всемирный: всемирной
организация: организацией
воз: воз
детская: детским
фонд: фондом
юнисеф: юнисеф
запрет: запрет
въезд: въезд
журналист: журналистов журналистам журналисты
спустя: спустя
месяц: месяцев
начало: начала
спровоцировать: спровоцированной
террористический: террористическими
атака: атаками
хамас: хамас
израиль: израиль
израильский: израильские израильскими
власть: власти
по-прежнему: по-прежнему
запрещать: запрещают
иностранный: иностранным иностранные
въезжать: въезжать
освещать: освещают освещать
конфликт: конфликты
это: это
сложиться: сложившаяся
практик: практика
заявить: заявил
комиссар: комиссар
филипп: филипп
лаззарини: лаззарини
призвать: призвав
активный: активнее
добиваться: добиваться
доступ: доступа
свободно: свободно
событие: события
палестинский: палестинские палестинских палестинского
вызывать: вызывают
восхищение: восхищение
несмотря: несмотря
многие: многие
погибнуть: погибли погибших
мужественно: мужественно
продолжать: продолжают
делать: делать
свое: свое
нуждаться: нуждаются
поддержка: поддержке
коллега: коллег
сказать: сказал
насилие: насилие насилия
западный: западном
беречь: берегу
поступать: поступать
сообщение: сообщения
столкновение: столкновениях
оккупировать: оккупированном
результат: результате
который: которых которые
дженине: дженине
тулькарме: тулькарме
двое: двое
спецкоординатор: спецкоординатор
ближневосточный: ближневосточному
мирный: мирному
процесс: процессу
тора: тор
веннесланд: веннесланд
осудить: осудил
действие: действия
привести: привели
гибель: гибели
несовершеннолетний: несовершеннолетних
потрясный: потрясен
трагический: трагическим
убийство: убийством
два: двух
совершить: совершенным
сила: силами силы
военный: военных
операция: операций
написать: написал
свой: своей
страничка: страничке
социальный: социальной
сеть: сети
четверг: четверг
призывать: призываю
немедленный: немедленному
тщательный: тщательному
расследование: расследованию
этот: этих
инцидент: инцидентов
подчеркивать: подчеркивая
настоятельный: настоятельную
необходимость: необходимость
привлечение: привлечения
ответственность: ответственности
виновный: виновных
обеспечение: обеспечения
гражданский: гражданских гражданского
лицо: лиц
жизнь: жизнь жизней
каждый: каждого каждым
бесценный: бесценна
потеря: потеря
столько: стольких
молодая: молодых
служить: служит
мрачный: мрачным
напоминание: напоминанием
насколько: насколько
предпринять: предпринять
сегодня: сегодня
решительный: решительные
остановить: остановить
также: также
подтвердить: подтвердили
масштаб: масштабы
разрушенье: разрушений
расширяться: расширяются
часом: часом
дать: данным
прошедший: прошедшая
стать: стала
сам: самой
фатальный: фатальной
население: населения
ноябрь: ноября
прошлый: прошлого
многочисленный: многочисленных
оказаться: оказалось
семеро: семеро
неприемлемый: неприемлемо
немедленно: немедленно
прекратиться: прекратиться
настаивать: настаивают
управление: управление
координация: координации
укгв: укгв
предупреждать: предупреждает
учреждение: учреждения
находиться: находятся
практический: практически
осада: осаде
передвижение: передвижение
машина: машин
скорый: скорой
персонал: персонала
крайне: крайне
ограничить: ограничено
фон: фоне
расти: растущей
нестабильность: нестабильности
чрезмерный: чрезмерного
применение: применения
ухудшаться: ухудшается
положение: положение
чрезвычайный: чрезвычайной
подписываться: подписывайтесь
наш: нашу наши
рассылка: рассылку
загружать: загружайте
приложение: приложение
мобильный: мобильных
устройство: устройств
обстрел: обстрелы
бомбардировка: бомбардировки
задерживать: задерживают
боевой: боевые
препятствовать: препятствуют
усилие: усилиям
шесть: шесть
ранение: ранения
удар: удара
ресурс: ресурсы
информация: информация
новостной: новостные
анонс: анонсы
журнал: журнал
отчет: отчеты
заседание: заседаниях
аудиовизуальный: аудиовизуальные
материал: материалы
общение: общение
твиттер: твиттер
главное: главные
брифинг: брифингов
стенограмма: стенограммы
комментарий: комментарии
интернет: интернете
фейсбук: фейсбук
вконтакте: вконтакте
контакт: контакты
пользоваться: пользоваться
сайт: сайтом
указатель: указатель
часто: часто
задавать: задаваемые
вопрос: вопросы
остерегаться: остерегайтесь
мошенничество: мошенничества
конфиденциальность: конфиденциальность
условие: условия
пользование: пользования
пожертвование: пожертвования