воз: воз
призывать: призывает призываем
европеец: европейцев
пересмотреть: пересмотреть пересмотрев
свое: свое своем свои
отношение: отношение отношении отношения отношений
алкоголь: алкоголю алкоголя алкоголь алкоголем
новость: новости
оон: оон
перейти: перейти
основное: основному
добро: добро
пожаловать: пожаловать
русский: русский
другой: другие другим другими
глобальный: глобальный
взгляд: взгляд
человеческий: человеческие
судьба: судьбы
поиск: поиск
расширить: расширенный
язык: язык
меню: меню
главный: главная
азия: азия
америка: америка
африка: африка
ближний: ближний
восток: восток
европа: европа
тема: темы теме
гуманитарный: гуманитарная
помощь: помощь
беженец: беженцы
мигрант: мигранты
женщина: женщины женщин
здравоохранение: здравоохранение здравоохранения
климат: климат
окружать: окружающая
среда: среда среды
культура: культура
образование: образование
международный: международное
правый: право права
мир: мир мире
безопасность: безопасность
генеральный: генеральный генерального
секретарить: секретарь секретаря
человек: человека людей людьми человеку людям
цель: цели
устойчивый: устойчивого
развитие: развития развитие развитию
экономический: экономическое
подробный: подробнее
интервью: интервью
сюжет: сюжеты
экспресс-новости: экспресс-новости
фоторепортаж: фоторепортажи
пресс-секретарь: пресс-секретарь
выступление: выступления
заявление: заявления
пресса: прессой
официальный: официальные
поездка: поездки
фотография: фотографии
пресс-релиз: пресс-релизы
группа: группа
аккредитация: аккредитации
сми: сми
интернет-трансляция: интернет-трансляция
аудиотека: аудиотека
подписаться: подписаться
фото: фото
возсволков: возсволков
онкологический: онкологические
заболевание: заболевания заболеваниями
мочь: могут
связанный: связаны
употребление: употреблением употребление
печать: печать
октябрь: октября
являться: является
причина: причиной
каждый: каждой
смерть: смерти
европейский: европейском европейских европейского европейский
регион: регионе регион
всемирный: всемирной
организация: организации
новый: новая новую
кампания: кампания кампанию кампании
направить: направлена
изменить: изменить изменили
ситуация: ситуацию
связывать: связывают
который: которых которой которые который
меньший: меньшей
мера: мере
семь: семь
вид: видов
рак: рака рак раке
включать: включая
грудь: груди
толстый: толстой
кишка: кишки
однако: однако
несмотря: несмотря
такой: такие
серьезный: серьезные
риск: риски
здоровье: здоровья здоровье
менее: менее
половина: половины
знать: знают
связь: связи
спиртное: спиртными
напиток: напитками
онкология: онкологией онкология
все: всем
проводиться: проводится
месяц: месяц
осведомленность: осведомленности
обращать: обращают
внимание: внимание
факт: факт фактах
процент: процент
страна: странах стран
потребление: потребление потребления
небольшой: небольших
количество: количествах
потенциально: потенциально
вести: вести ведет
информационный: информационная информационную
именно: именно
поэтому: поэтому
региональный: региональное регионального
бюро: бюро
начинать: начинает
рамка: рамках
быть: будут
распространяться: распространяться
дать: данные
последний: последних последние
исследование: исследований
влияние: влиянии
получить: получившая
название: название
переосмыслить: переосмыслить
проблема: проблему проблемам
задуматься: задуматься
общество: общества общество обществе
личной: личном личного
роль: роль
повседневный: повседневной
жизнь: жизни жизнь жизней
праздник: праздниках
традиция: традициях
помимо: помимо
физический: физических физического
последствие: последствий
также: также
масштабный: масштабным
социальный: социальным
объяснять: объясняет
годный: годен
галеа: галеа
советник: советник
директор: директора
один: одним
основной: основных
фактор: факторов
приводить: приводящих
насилие: насилию насилие
сексуальный: сексуальное
гендерный: гендерное
дорожный: дорожному
травматизм: травматизму
страдать: страдают
сам: сами
пить: пьющие
семья: семьи
целый: целом
конечный: конечном
счет: счете
должен: должны должен должна
возможность: возможность
делать: делать
осознать: осознанный осознав
выбор: выбор
речь: речь
идти: идет
поведение: поведении
делиться: делимся
информация: информацией информация
основать: основанной
привычка: привычки
политик: политиков политиками
орган: органы
помочь: помочь
осуществить: осуществить
широкий: широкие
культурный: культурные
изменение: изменения
касаться: касающиеся
восприниматься: воспринимается
регулироваться: регулируется
говорить: говорит
история: истории
опыт: опыта
жесткий: жесткое жесткого
регулирование: регулирование регулирования
течение: течение
ноябрь: ноября
распространять: распространять
место: места
рассказывать: рассказывают
многочисленный: многочисленных
преимущество: преимуществах
сокращение: сокращения
полный: полного полным
отказ: отказа
улучшение: улучшение
состояние: состояния
психический: психического
восприятие: восприятием
индивидуальный: индивидуальный
иметь: имеет
большой: большое
значение: значение
увы: увы
недостаточно: недостаточно
наш: нашем нашу наши
слишком: слишком
дешевый: дешев
доступный: доступен
активно: активно
рекламироваться: рекламируется
создать: создать
условие: условия
любой: любому
простой: проще
сделать: сделать
польза: пользу
здоровый: здоровых здорового
альтернатива: альтернатив
продукт: продукт
причинять: причиняет
вред: вреда
предмет: предметом
сотрудничество: сотрудничеству
сторонник: сторонниками
образ: образа
способствовать: способствовать
формирование: формированию
сократить: сократить
читать: читайте
деятельность: деятельность
четыре: четырех
отрасль: отраслей
промышленность: промышленности
ежегодно: ежегодно
уносить: уносит
миллион: миллиона
подписываться: подписывайтесь
рассылка: рассылку
загружать: загружайте
приложение: приложение
мобильный: мобильных
устройство: устройств
диагностировать: диагностировать
предотвращать: предотвращать
лечить: лечить
исключение: исключения
число: число
раковый: раковых
больной: больных
продолжить: продолжит
расти: расти
умирать: умирает
результат: результате
болезный: болезней
сердце: сердца
ресурс: ресурсы
партнер: партнеров
новостной: новостные
анонс: анонсы
журнал: журнал
отчет: отчеты
заседание: заседаниях
аудиовизуальный: аудиовизуальные
материал: материалы
общение: общение
твиттер: твиттер
главное: главные
брифинг: брифингов
стенограмма: стенограммы
комментарий: комментарии
журналист: журналистов
интернет: интернете
фейсбук: фейсбук
вконтакте: вконтакте
контакт: контакты
пользоваться: пользоваться
сайт: сайтом
указатель: указатель
часто: часто
задавать: задаваемые
вопрос: вопросы
остерегаться: остерегайтесь
мошенничество: мошенничества
конфиденциальность: конфиденциальность
пользование: пользования
пожертвование: пожертвования