воз: воз
европа: европа европе европы европу
смочь: сможет
победить: победить
оспа: оспу оспы оспе оспой оспа
обезьяна: обезьян
должен: должна должны
поддержать: поддержать
африка: африку африка африкой африки африке
вакцина: вакцинами вакцины вакцинам вакцину
новость: новости
оон: оон
перейти: перейти
основное: основному основном
добро: добро
пожаловать: пожаловать
русский: русский
другой: другие
глобальный: глобальный
взгляд: взгляд
человеческий: человеческие
судьба: судьбы
поиск: поиск
расширить: расширенный
язык: язык
меню: меню
главный: главная
азия: азия
америка: америка
ближний: ближний ближайшие
восток: восток
тема: темы теме
гуманитарный: гуманитарная
помощь: помощь
беженец: беженцы
мигрант: мигранты
женщина: женщины
здравоохранение: здравоохранение здравоохранения
климат: климат
окружать: окружающая
среда: среда
культура: культура
образование: образование
международный: международное международной международные
правый: право права
мир: мир миру мире мира
безопасность: безопасность
генеральный: генеральный генерального
секретарить: секретарь секретаря
человек: человека человек человеку
цель: цели
устойчивый: устойчивого
развитие: развития развитие
экономический: экономическое
подробный: подробнее
интервью: интервью
сюжет: сюжеты
экспресс-новости: экспресс-новости
фоторепортаж: фоторепортажи
пресс-секретарь: пресс-секретарь
выступление: выступления
заявление: заявления
пресса: прессой
официальный: официальные
поездка: поездки
фотография: фотографии
пресс-релиз: пресс-релизы
группа: группа
аккредитация: аккредитации
сми: сми
интернет-трансляция: интернет-трансляция
аудиотека: аудиотека
подписаться: подписаться
возх: возх
мостафа: мостафа
рекомендовать: рекомендует
использовать: использовать
печать: печать
август: августа
европейский: европейские европейским
правительство: правительства правительством
продемонстрировать: продемонстрировать
твердый: твердую
политический: политическую
приверженность: приверженность
ликвидация: ликвидации
вспышка: вспышки вспышку
проявить: проявив
солидарность: солидарность солидарности
заявить: заявил
вторник: вторник
директор: директор
региональный: регионального
бюро: бюро
всемирный: всемирной
организация: организации
ханс: ханс
клюге: клюге
выступать: выступая
журналист: журналистами журналистов
женева: женеве
доктор: доктор
подчеркнуть: подчеркнул
опасность: опасность
население: населения
целый: целом
небольшой: невелика
отвергнуть: отверг
сравнение: сравнения
быстро: быстро
распространяться: распространяющимся
вирусный: вирусным
заболевание: заболеванием заболевания заболеваний
который: которое который которая
агентство: агентство
объявить: объявило
прошлый: прошлой прошлом
неделя: неделе
чрезвычайный: чрезвычайной
ситуация: ситуацией
область: области
общественный: общественного
пандемия: пандемией пандемии
характер: характер
передача: передачи
современный: современные
научный: научные
знание: знания
вирус: вирусе вирусом вирус вирусы
указывать: указывают
передаваться: передается передающихся
контакт: контакт контакты
кожа: кожей
заразить: зараженного
число: числе число числа
время: время
секс: секса
вопрос: вопросы вопросе
быть: будут
ввести: введены
ограничение: ограничения
подобный: подобные
существовать: существовали
представитель: представитель
однозначно: однозначно
ответить: ответил
напомнить: напомнил
год: году года годы
удаться: удалось
взять: взять
контроль: контроль контроля
непосредственный: непосредственному
взаимодействие: взаимодействию
наиболее: наиболее
пострадать: пострадавшими
сообщество: сообществами
мужчина: мужчин мужчинами
вступать: вступающих
половой: половые
качество: качестве
фактор: факторов
успех: успеха
назвать: назвал
изменение: изменение
поведение: поведения
недискриминационный: недискриминационные
мера: меры мер
орган: органов органам
вакцинация: вакцинацию
однако: однако
слово: словам
регион: регионе регионах
окончательно: окончательно
болезнь: болезнь
настоящее: настоящее
ежемесячно: ежемесячно
регистрироваться: регистрируется
новый: новых
случай: случаев случай
заражение: заражения
это: этим
мутировать: мутирует
швеция: швеция швеции
стать: стала стало станет
первый: первой
страна: страной страны странам
предел: пределами
зарегистрировать: зарегистрирован зарегистрировано
вариант: вариантом варианты
клад: клада клады кладе
штамм: штамм
прима: прим
редакция: ред
вызвать: вызвал
последний: последнюю последние
распространиться: распространившуюся
демократический: демократической
республика: республики
конго: конго
дрк: дрк
соседний: соседние
заболеть: заболел
путешествовать: путешествовал
затронуть: затронутые
район: районы
активный: активная
борьба: борьба
распространение: распространением распространение
считаться: считается
серьезнойчем: серьезнойчем
давать: дает
возможность: возможность возможностями
усилить: усилить
внимание: внимание
ликвидировать: ликвидировать
навсегда: навсегда
работать: работают
призвать: призвал
частность: частности
справедливый: справедливого
доступ: доступа
также: также
недоступный: недоступны
изначально: изначально
разработать: разработаны
противодействие: противодействия
ныне: ныне
искоренить: искорененной
тарик: тарик
ясаревич: ясаревич
производитель: производитель
базироваться: базирующаяся
копенгаген: копенгагене
компания: компания
располагать: располагает
производство: производства
миллион: миллионов
доза: доз
конец: концу
поставить: поставить
два: двух
касаться: касается
производиться: производится
заказ: заказу
япония: японии япония
накопить: накоплены
значительный: значительные
запас: запасы
препарат: препарата
очень: очень
щедрый: щедра
пожертвование: пожертвования
онаведет: онаведет
переговоры: переговоры
сказать: сказал
смерть: смертей
возк: возк
малиро: малиро
усилие: усилия
отметить: отметил
положительный: положительным
наследие: наследием
ответный: ответных
укрепление: укрепление
лабораторный: лабораторного
потенциал: потенциала
все: всему всем
позволять: позволяющее
выявлять: выявлять
различный: различные
мочь: можем
бороться: бороться
вместе: вместе
континент: континентах
добавить: добавил
свое: своего
коллега: коллеги
нужно: нужно
создавать: создавать
система: системы
противный: противном
случать: случаемы
попасть: попадем
очередной: очередной
цикл: цикл
паника: паники
отреагировать: отреагируем
решающий: решающим
испытание: испытанием
подписываться: подписывайтесь
наш: нашу наши
рассылка: рассылку
загружать: загружайте
приложение: приложение
мобильный: мобильных
устройство: устройств
помогать: помогает
предотвращать: предотвращать
расти: растет
животное: животных
тревога: тревогу
связь: связи
беспрецедентный: беспрецедентным
рост: ростом
ресурс: ресурсы
информация: информация
партнер: партнеров
новостной: новостные
анонс: анонсы
журнал: журнал
отчет: отчеты
заседание: заседаниях
аудиовизуальный: аудиовизуальные
материал: материалы
общение: общение
твиттер: твиттер
главное: главные
брифинг: брифингов
стенограмма: стенограммы
комментарий: комментарии
интернет: интернете
фейсбук: фейсбук
вконтакте: вконтакте
пользоваться: пользоваться
сайт: сайтом
указатель: указатель
часто: часто
задавать: задаваемые
остерегаться: остерегайтесь
мошенничество: мошенничества
конфиденциальность: конфиденциальность
условие: условия
пользование: пользования