юнисеф: юнисеф
запросить: запросил
миллион: млн миллионов
доллар: долларов
остановить: остановить
вспышка: вспышку вспышке вспышки
обезьяна: обезьян
африка: африке африка африки
новость: новости
оон: оон
перейти: перейти
основное: основному
добро: добро
пожаловать: пожаловать
русский: русский
другой: другие
глобальный: глобальный
взгляд: взгляд
человеческий: человеческие
судьба: судьбы
поиск: поиск
расширить: расширенный
язык: язык
меню: меню
главный: главная
азия: азия
америка: америка
ближний: ближний
восток: восток
европа: европа
тема: темы тему теме
гуманитарный: гуманитарная гуманитарной
помощь: помощь помощи
беженец: беженцы
мигрант: мигранты
женщина: женщины
здравоохранение: здравоохранение здравоохранения
климат: климат
окружать: окружающая
среда: среда
культура: культура
образование: образование образования
международный: международное
правый: право права
мир: мир
безопасность: безопасность
генеральный: генеральный генерального
секретарить: секретарь секретаря
человек: человека люди человеку
цель: цели
устойчивый: устойчивого
развитие: развития развитие
экономический: экономическое
подробный: подробнее
интервью: интервью
сюжет: сюжеты
экспресс-новости: экспресс-новости
фоторепортаж: фоторепортажи
пресс-секретарь: пресс-секретарь
выступление: выступления
заявление: заявления
пресса: прессой
официальный: официальные
поездка: поездки
фотография: фотографии
пресс-релиз: пресс-релизы
группа: группа
аккредитация: аккредитации
сми: сми
интернет-трансляция: интернет-трансляция
аудиотека: аудиотека
подписаться: подписаться
вирус: вирус вируса
оспа: оспы оспой оспа
красный: красного
цвет: цвета
инфицированный: инфицированной инфицированными
клетка: клетки
синий: синяя
печать: печать
сентябрь: сентября
детский: детский
фонд: фонд
обратиться: обратился
призыв: призывом
срочный: срочно
выделить: выделить
поддержка: поддержки
усилие: усилий
предотвращение: предотвращению
стремительный: стремительного
распространение: распространения распространение
шесть: шести
африканский: африканских
страна: странах страны странам
включать: включая
бурунди: бурунди
страдать: страдают
ребенок: дети детей
зарегистрировать: зарегистрированных зарегистрировано
случай: случаев случая случаях
два: две
треть: трети
это: это
возраст: возрасте
год: лет год
ситуация: ситуация ситуацией
стремительно: стремительно
обостряться: обостряется
последний: последние
неделя: недели
число: число числом
увеличиться: увеличилось
процент: процентов
сообщить: сообщил
пол: пол
нгвакум: нгвакум
региональный: региональный
советник: советник
вопрос: вопросам вопросы
восточный: восточной
южный: южной
сегодняшний: сегодняшний
деть: день
тысяча: тысяч тысячи
подозрение: подозрения
заболевание: заболевание заболевания заболеваний
один: одного
смерть: смерти смертей
соседний: соседней
демократический: демократической
республика: республике
конго: конго
зафиксировать: зафиксировано
представитель: представитель
подчеркнуть: подчеркнул
наличие: наличии
финансирование: финансирования
оперативный: оперативных
действие: действий
возможность: возможность
положить: положить
конец: конец
нынешний: нынешней
очень: очень
короткий: короткие
срок: сроки
географический: географическая
область: область
ограничить: ограничена
создание: создание
безопасный: безопасных
класс: классов
начало: начале
стартовать: стартовал
учебный: учебный
помочь: помочь
учитель: учителям
родитель: родителям
понять: понять
риск: риски
свести: свести
минимум: минимуму
последствие: последствия
опасный: опасного
оказывать: оказывает
орган: органам
проведение: проведении
санитарно-гигиенический: санитарно-гигиенических
мероприятие: мероприятий
школа: школах
обучение: обучении
персонал: персонала
распознавание: распознаванию
ранний: ранних
симптом: симптомов
усиление: усилении
гигиена: гигиены
рука: рук
быть: будем
заблуждаться: заблуждаться
ответ: ответов
возникнуть: возникшие
кто: кого
быстро: быстро
развивающийся: развивающаяся
новый: новым новых новой
заразный: заразным
штамм: штаммом
каждый: каждым
днем: днем
узнать: узнаем узнают
путь: путях
передача: передачи передачей
получение: получением
информация: информации информация
обновлять: обновляем
наш: наши нашу
рекомендация: рекомендации
планировать: планируем планирует
ответный: ответные
мера: меры мер
клеймо: клеймо
позор: позора позором
также: также
оказание: оказание
психологический: психологической
медик: медикам медики
работать: работающим
передовой: передовой
линия: линии
реагирование: реагирования
который: которые который
мочь: могут
столкнуться: столкнуться
враждебность: враждебностью
сторона: стороны
некоторые: некоторых
община: общин
заражение: заражение заражения
часто: часто
ассоциироваться: ассоциируется
секс: сексом секса
действительно: действительно
являться: является
причина: причиной
инфекция: инфекции
далеко: далеко
предупреждать: предупреждают
кто-то: кого-то
передаваться: передающееся передающихся
половой: половым
путем: путем
клеймить: клеймят
обсуждать: обсуждать
принять: принято
объяснять: объясняет
пытаться: пытаемся
объяснить: объяснить объяснила
существовать: существуют
заблуждение: заблуждения
большинство: большинство
заражаться: заражаются
обычный: обычных
бытовой: бытовых
прикосновение: прикосновений
контакт: контакт контакты
животное: животными животных
материал: материалами материалы
иметь: имеет
общий: общего
сравнение: сравнение
статистика: статистики
смертность: смертности
говорить: говоря
разительный: разительном
контраст: контрасте
высокий: высоким
предполагать: предполагаемых
дрк: дрк
отсутствие: отсутствием
подобный: подобных
инцидент: инцидентов
доктор: доктор
маргарета: маргарет
харрис: харрис
всемирный: всемирной
организация: организации
воз: воз
скорый: скорее
связанный: связано
длительный: длительной
чрезвычайный: чрезвычайной
частить: части
многие: многих
погибнуть: погибли
сильный: сильно
ослабить: ослаблен
иммунитет: иммунитет
хронический: хронического
недоедание: недоедания
условие: условиях условия
конфликт: конфликта
возможно: возможно
сопутствовать: сопутствующих
сказать: сказала
выступать: выступая
женева: женеве
подписываться: подписывайтесь
рассылка: рассылку
загружать: загружайте
приложение: приложение
мобильный: мобильных
устройство: устройств
помогать: помогает
выявлять: выявлять
предотвращать: предотвращать
расти: растет
одобрить: одобрила
первый: первый
диагностический: диагностический
метод: метод
выявление: выявления
ресурс: ресурсы
партнер: партнеров
новостной: новостные
анонс: анонсы
журнал: журнал
отчет: отчеты
заседание: заседаниях
аудиовизуальный: аудиовизуальные
общение: общение
твиттер: твиттер
главное: главные
брифинг: брифингов
стенограмма: стенограммы
комментарий: комментарии
журналист: журналистов
интернет: интернете
фейсбук: фейсбук
вконтакте: вконтакте
пользоваться: пользоваться
сайт: сайтом
указатель: указатель
задавать: задаваемые
остерегаться: остерегайтесь
мошенничество: мошенничества
конфиденциальность: конфиденциальность
пользование: пользования
пожертвование: пожертвования