воз: воз
государственный: государственные государственного государственное
расход: расходы расходов расходами расходам расходах
здравоохранение: здравоохранение здравоохранения здравоохранению
снижаться: снижаются
новость: новости
оон: оон
перейти: перейти
основное: основному
добро: добро
пожаловать: пожаловать
русский: русский
другой: другие другими
глобальный: глобальный глобальные глобальной глобального
взгляд: взгляд
человеческий: человеческие
судьба: судьбы
поиск: поиск
расширить: расширенный
язык: язык
меню: меню
главный: главная
азия: азия азии
америка: америка
африка: африка
ближний: ближний
восток: восток
европа: европа европе
тема: темы теме
гуманитарный: гуманитарная
помощь: помощь помощи
беженец: беженцы
мигрант: мигранты
женщина: женщины
климат: климат
окружать: окружающая
среда: среда
культура: культура
образование: образование
международный: международное международному
правый: право права
мир: мир миру мире мира
безопасность: безопасность
генеральный: генеральный генерального
секретарить: секретарь секретаря
человек: человека человек людей
цель: цели
устойчивый: устойчивого
развитие: развития развитие
экономический: экономическое
подробный: подробнее
интервью: интервью
сюжет: сюжеты
экспресс-новости: экспресс-новости
фоторепортаж: фоторепортажи
пресс-секретарь: пресс-секретарь
выступление: выступления
заявление: заявления
пресса: прессой
официальный: официальные
поездка: поездки
фотография: фотографии
пресс-релиз: пресс-релизы
группа: группа
аккредитация: аккредитации
сми: сми
интернет-трансляция: интернет-трансляция
аудиотека: аудиотека
подписаться: подписаться
юнисефамэльфати: юнисефамэльфати
вакцинация: вакцинация
ребенок: ребенка
судан: судане
печать: печать
декабрь: декабря
расчет: расчете
душ: душу
население: населения
снизиться: снизились
все: всему всем
год: году годом годах лет года годы
сравнение: сравнению
рост: роста
время: время
пандемия: пандемии
говориться: говорится
новый: новом
доклад: докладе доклада
всемирный: всемирной всемирный
организация: организации
приурочить: приуроченном
день: дню дня
всеобщий: всеобщего всеобщий
охват: охвата охват
услуга: услугами услугам услуг услуги
который: который
ежегодно: ежегодно
отмечаться: отмечается
иметь: имеют иметь
ключевой: ключевое
значение: значение
обеспечение: обеспечения обеспечению
доступ: доступа доступ
снижение: снижение
тяжелый: тяжелые
последствие: последствия
особенно: особенно
условие: условиях условием условия
миллиард: миллиарда
базовый: базовым
медицинский: медицинским медицинских медицинские медицинскую медицинской медицинскими
сталкиваться: сталкиваются
финансовый: финансовыми финансовых финансовой
трудность: трудностями трудностей
расширяться: расширяется
оказываться: оказываются
черта: чертой
бедность: бедности
связь: связи
использование: использованием использования
деть: день
напоминать: напоминает
мы: нам
здоровье: здоровье здоровья
означать: означает
доступность: доступность
препятствие: препятствий
заявить: заявил
директор: директор
тедрос: тедрос
адханом: адханом
гебрейесус: гебрейесус
оплачивать: оплачивает оплачивают
защита: защита защиты
связанный: связанных связанные связанной
прямая: прямыми
являться: является
основополагающий: основополагающим
достижение: достижения достижений
читать: читайте
также: также
процент: процентов
семья: семей
центральный: центральной
мочь: могут
позволить: позволить позволили
проблема: проблемы проблему
отсутствие: отсутствием
сфера: сфере
ограничиваться: ограничиваются
бедный: бедными бедных
страна: странами странах стран
высокий: высоким
уровень: уровнем уровне
доход: доходов
платеж: платежи
сопрячь: сопряжены
самый: самых
слой: слоев
такой: такая
ситуация: ситуация ситуации
вынуждать: вынуждать
отказываться: отказываться
необходимый: необходимой необходимы
последний: последним последние
дать: данным данные данных
треть: трети
свыше: свыше
общий: общих
сам: сами
пациент: пациенты
призывать: призывает
лидер: лидеров лидеры
сделать: сделать
национальный: национальным национальных
приоритет: приоритетом
устранить: устранить
урок: уроки
период: период
система: системам
оперативно: оперативно
реагировать: реагировать
чрезвычайный: чрезвычайные
это: это
продемонстрировать: продемонстрировало
преимущество: преимущества
бюджет: бюджета
финансирование: финансировании финансирование
общественный: общественного
профилактический: профилактических
мероприятие: мероприятий
схема: схемами
кризис: кризиса
обеспечить: обеспечило
расширение: расширение
спасение: спасение
больший: большего
число: числа
жизнь: жизней
усилие: усилия
принятие: принятия
эффективный: эффективных
решение: решений
инвестиция: инвестициях
своевременный: своевременные
надежный: надежные
структура: структуре
протяжение: протяжении
отслеживать: отслеживает
главное: главных главные
создание: создание
баз: базы
содержать: содержащей
информация: информацию информация
ежегодный: ежегодная
публикация: публикация
общедоступный: общедоступные
ресурс: ресурсы
способствовать: способствуют
прозрачность: прозрачности
подотчетность: подотчетности
политик: политике
лион: лионе
франция: франция
собираться: собираются
представитель: представители
орган: органов
глава: главы
страновой: страновых
офис: офисов
советник: советники
оценить: оценить
прогресс: прогресс
определить: определить
приоритетный: приоритетные
направление: направления
работа: работы
наметить: наметить
повестка: повестку
следующий: следующий
этап: этап
партнерство: партнерства
подписываться: подписывайтесь
наш: нашу наши
рассылка: рассылку
загружать: загружайте
приложение: приложение
мобильный: мобильных
устройство: устройств
мировой: мировые
пообещать: пообещали
удвоить: удвоить
четверг: четверг
украина: украина
россия: россия
саммит: саммит
будущее: будущего
партнер: партнеров
новостной: новостные
анонс: анонсы
журнал: журнал
отчет: отчеты
заседание: заседаниях
аудиовизуальный: аудиовизуальные
материал: материалы
общение: общение
твиттер: твиттер
брифинг: брифингов
стенограмма: стенограммы
комментарий: комментарии
журналист: журналистов
интернет: интернете
фейсбук: фейсбук
вконтакте: вконтакте
контакт: контакты
пользоваться: пользоваться
сайт: сайтом
указатель: указатель
часто: часто
задавать: задаваемые
вопрос: вопросы
остерегаться: остерегайтесь
мошенничество: мошенничества
конфиденциальность: конфиденциальность
пользование: пользования
пожертвование: пожертвования