румыния: румыния румынии
страна: страна
самый: самым самый самая
высокий: высоким высокий высокая высок
мир: мире мир
уровень: уровнем уровень уровне
детская: детской
смертность: смертности
пневмония: пневмонии пневмонией пневмония
новость: новости
оон: оон
перейти: перейти
основное: основному
добро: добро
пожаловать: пожаловать
русский: русский
другой: другие другими других
глобальный: глобальный
взгляд: взгляд
человеческий: человеческие
судьба: судьбы
поиск: поиск
расширить: расширенный
язык: язык
меню: меню
главный: главная
азия: азия
америка: америка
африка: африка
ближний: ближний
восток: восток
европа: европа
тема: темы теме
гуманитарный: гуманитарная
помощь: помощь помощи
беженец: беженцы
мигрант: мигранты
женщина: женщины
здравоохранение: здравоохранение здравоохранения
климат: климат
окружать: окружающая
среда: среда
культура: культура
образование: образование образования
международный: международное
правый: право права
безопасность: безопасность
генеральный: генеральный генерального
секретарить: секретарь секретаря
человек: человека
цель: цели
устойчивый: устойчивого
развитие: развития развитие
экономический: экономическое
подробный: подробнее
интервью: интервью
сюжет: сюжеты
экспресс-новости: экспресс-новости
фоторепортаж: фоторепортажи
пресс-секретарь: пресс-секретарь
выступление: выступления
заявление: заявления
пресса: прессой
официальный: официальные
поездка: поездки
фотография: фотографии
пресс-релиз: пресс-релизы
группа: группа
аккредитация: аккредитации
сми: сми
интернет-трансляция: интернет-трансляция
аудиотека: аудиотека
подписаться: подписаться
юнисеф: юнисеф
пятилетняя: пятилетняя
антоний: антония антонии антонию
госпитализировать: госпитализирована госпитализировали
возраст: возрасте возраста
два: двух
год: лет года году
девочка: девочка
сей: сих
пора: пор
страдать: страдает
осложнение: осложнений осложнения
печать: печать
ноябрь: ноября
каждый: каждая каждый каждого каждые
четвертая: четвертая
смерть: смерть смерти
маленький: маленьких
ребенок: детей детьми ребенка дети детям ребенок
вызвать: вызвана вызванных
это: это
показатель: показатель
детский: детский
фонд: фонд
сотрудничество: сотрудничестве
местный: местными местные местном
орган: органами
пытаться: пытается пытаются
решить: решить
проблема: проблему проблема
долгосрочный: долгосрочные долгосрочных долгосрочной
последствие: последствия
сидеть: сидит сидеть
дома: дома
несколько: несколько
день: дней
очень: очень
часто: часто
оказываться: оказывается
изоляция: изоляции
здоровье: здоровьем здоровье
небольшой: небольшая
простуда: простуда
привести: привести
госпитализация: госпитализации
любить: любит
играть: играть
улица: улице
ходить: ходить
сад: сад
спрашивать: спрашивает
деть: день
бабушка: бабушка бабушкой
завтра: завтра
пойти: пойду
говорить: говорит
мария: мария марией
ответ: ответ
вопрос: вопрос вопросам вопросы
слышать: слышит
подолгу: подолгу
приходиться: приходится
избегать: избегать
контакт: контактов контакты
защитить: защитить
свое: свое своих
хрупкий: хрупкое
выписка: выписки
лечение: лечение
необходимо: необходимо
продолжать: продолжать
дом: дому
однако: однако
семья: семья семьи
мочь: могла могут
позволить: позволить
дорогостоящий: дорогостоящий
курс: курс
терапия: терапии
подняться: поднялась
температура: температура
начаться: начались началась
судорога: судороги
момент: момент
подумать: подумала
потерять: потеряли
три: трех
вспоминать: вспоминает
свой: своей
тяжелый: тяжелая
ситуация: ситуация
сельский: сельских сельской
район: районах
борьба: борьба
достигнуть: достигла достигли
значительный: значительных
успех: успехов
все: всем
исключение: исключение
острый: острее
ощущаться: ощущается
ограничить: ограничен
доступ: доступ
услуга: услугам услугами услуг услуги
социальный: социальной
поддержка: поддержки поддержке
многие: многие многих
жить: живут живет
бедность: бедности
существовать: существует
множество: множество
причина: причин
который: которые который которая которых которым
влиять: влияют
предотвратимый: предотвратимых
респираторный: респираторных респираторное
заболевание: заболеваний заболевание
особенно: особенно
доктор: доктор доктором
овидиу: овидиу
эмилиан: эмилиан
бибире: бибире
семейный: семейный
врач: врач врачу врачом
работать: работает
община: общине общины
корбаска: корбаска
слово: словам
большой: большое
число: число
родитель: родителей
местность: местности
потенциально: потенциально
менее: менее
подготовить: подготовлены
трудность: трудностям
воспитание: воспитания
кроме: кроме
отмечать: отмечает
специалист: специалист
задержка: задержки
оказание: оказании
медицинский: медицинской медицинскую
тот: тому
стать: станет стану
хронический: хроническим
недоверие: недоверие
вакцина: вакцинам вакцины вакцина
сесилия: сесилия
лукач: лукач
возглавлять: возглавляет
отдел: отделов
департамент: департамента
общественный: общественного общественные общественных
провинция: провинции
бакэу: бакэу
расположить: расположена
также: также
указывать: указывает
подозрительный: подозрительное
отношение: отношение
вакцинация: вакцинации вакцинация
процент: процентов процентах
иммунизация: иммунизации
отказываться: отказываются
крайне: крайне
тревожный: тревожно
мой: моему
мнение: мнению
являться: является
один: одной
основной: основных
добавлять: добавляет
получить: получивших получившие получили получила
необходимый: необходимых необходимыми необходимую
прививка: прививок прививки
заболеть: заболевших
коклюш: коклюшем коклюша
случай: случаев случаи
развиваться: развиваются
серьезный: серьезные
вести: вести
обычно: обычно
предлагать: предлагаемая
часть: часть
дифтерия: дифтерии
столбняк: столбняка
акдс: акдс
обеспечивать: обеспечивает
-процентную: -процентную
защита: защиту защиты
болезнь: болезни
вовремя: вовремя
такой: такие таким таких
подверженный: подвержены
горазд: гораздо
больший: большему
риск: риску
краткосрочный: краткосрочной
перспектива: перспективе
медсестра: медсестра медсестрой
лэкрэмиоара: лэкрэмиоара
вранчану: вранчану
посещать: посещает посещаю
визит: визиты
центр: центры центров центрах
медработник: медработники
состоять: состоящей
семь: семи
деревня: деревень деревнях
обеспечить: обеспечить
рассказывать: рассказывает
усилие: усилиях
выявлять: выявляю
уязвимый: уязвимые
направлять: направляю
консультировать: консультирую
матерой: матерей
важность: важность важности
личной: личной
гигиена: гигиены
грудной: грудного
вскармливание: вскармливания
полноценный: полноценного
питание: питания
работа: работа
лэкрэмиоары: лэкрэмиоары
корбаске: корбаске
возглавить: возглавил
проект: проект
предоставление: предоставления
базовый: базовых
комплексный: комплексных
область: области
программа: программой
последовать: последовало
пилотирование: пилотирование
пять: пяти
интегрировать: интегрированных
рамка: рамках
флагманский: флагманской
инициатива: инициативы
запустить: запущенной
взрослый: взрослым взрослых
опекун: опекунов
дать: данный
предоставлять: предоставляемым
включать: включая
специализированный: специализированные
психологический: психологические
физиотерапия: физиотерапию
логопед: логопедов
принять: приняли
участие: участие
родительский: родительских
семинар: семинарах
прочий: прочего
рассказываться: рассказывается
первичный: первичной
медико-санитарный: медико-санитарной
знакомство: знакомству
лэкрэмиоарой: лэкрэмиоарой
информация: информацию информация
определиться: определилась
будущий: будущей
профессия: профессией
вырасти: вырасту
смочь: смогу
помочь: помочь
подписываться: подписывайтесь
наш: нашу наши
рассылка: рассылку
загружать: загружайте
приложение: приложение
мобильный: мобильных
устройство: устройств
секунда: секунд
погибать: погибает
участник: участники
встреча: встречи
барселона: барселоне
обязаться: обязались
всерьез: всерьез
бороться: бороться
метапневмовирус: метапневмовирус
нужно: нужно
знать: знать
распространение: распространении
инфекция: инфекции
китай: китае
ресурс: ресурсы
партнер: партнеров
новостной: новостные
анонс: анонсы
журнал: журнал
отчет: отчеты
заседание: заседаниях
аудиовизуальный: аудиовизуальные
материал: материалы
общение: общение
твиттер: твиттер
последний: последние
главное: главные
брифинг: брифингов
стенограмма: стенограммы
комментарий: комментарии
журналист: журналистов
интернет: интернете
фейсбук: фейсбук
вконтакте: вконтакте
пользоваться: пользоваться
сайт: сайтом
указатель: указатель
задавать: задаваемые
остерегаться: остерегайтесь
мошенничество: мошенничества
конфиденциальность: конфиденциальность
условие: условия
пользование: пользования
пожертвование: пожертвования