жар: жара
каждый: каждый
год: год года году
уносить: уносит
тысяча: тысяч
жизнь: жизней
европа: европе европа
защитить: защитить
близкие: близких близкие
новость: новости
оон: оон
перейти: перейти
основное: основному
добро: добро
пожаловать: пожаловать
русский: русский
другой: другие
глобальный: глобальный глобальная
взгляд: взгляд
человеческий: человеческие
судьба: судьбы
поиск: поиск
расширить: расширенный
язык: язык
меню: меню
главный: главная
азия: азия азии
америка: америка
африка: африка
ближний: ближний
восток: восток
тема: темы теме
гуманитарный: гуманитарная
помощь: помощь
беженец: беженцы
мигрант: мигранты
женщина: женщины женщин
здравоохранение: здравоохранение здравоохранения
климат: климат климатом
окружать: окружающая окружающих
среда: среда
культура: культура
образование: образование
международный: международное
правый: право права
мир: мир мира
безопасность: безопасность
генеральный: генеральный генерального
секретарить: секретарь секретаря
человек: человека человек людей людям
цель: цели
устойчивый: устойчивого
развитие: развития развитие
экономический: экономическое
подробный: подробнее
интервью: интервью
сюжет: сюжеты
экспресс-новости: экспресс-новости
фоторепортаж: фоторепортажи
пресс-секретарь: пресс-секретарь
выступление: выступления
заявление: заявления
пресса: прессой
официальный: официальные
поездка: поездки
фотография: фотографии
пресс-релиз: пресс-релизы
группа: группа
аккредитация: аккредитации
сми: сми
интернет-трансляция: интернет-трансляция
аудиотека: аудиотека
подписаться: подписаться
дданиэль: дданиэль
некоторые: некоторых
регион: регионах регионе регион региона
результат: результате
климатический: климатического
кризис: кризиса кризис
температура: температура температуры
подняться: поднялась
невыносимый: невыносимого
уровень: уровня
отмечать: отмечают
воз: воз
печать: печать
август: августа
ежегодно: ежегодно
причина: причин причиной
связанный: связанных связанной связанные
жара: жарой
погибать: погибают погибали
этот: эта
цифра: цифра
расти: расти
мера: мере меры
нагревание: нагревания
планет: планеты
пятница: пятницу
предупредить: предупредил
директор: директор
региональный: регионального
бюро: бюро
всемирный: всемирной
организация: организации
ханс: ханс
клюге: клюге
слово: словам
европейский: европейских европейском европейский европейского
страна: странах стран
повышаться: повышается
примерный: примерно
раз: раза
быстрый: быстрее
сравнение: сравнению
средний: средним среднем
мировой: мировым
показатель: показателем показатель
отметить: отметил
самый: самых
теплый: теплых теплое
история: историю
наблюденье: наблюдений
зафиксировать: зафиксированы
жара-убийца: жара-убийца
теплов: тепловой тепловых
стресс: стресс
являться: является
основной: основной
смертность: смертности
сказать: сказал
экстремальный: экстремальные экстремальной экстремальная
подобный: подобные
который: которые которую
переживать: переживаем
настоящее: настоящее
время: время
усугублять: усугубляют
хронический: хронические
заболевание: заболевания
включать: включая
сердечно-сосудистый: сердечно-сосудистые
респираторный: респираторные
цереброваскулярные: цереброваскулярные
болезнь: болезни
психический: психические
недуг: недуги
состояние: состояния
диабет: диабетом
крайний: крайняя
испытывать: испытываем
особенно: особенно
опасный: опасна опаснее
пожилой: пожилых пожилым
частность: частности
тот: тех
жить: живет живут
также: также
стать: стать
дополнительный: дополнительной
угроза: угрозой
беременная: беременных
ранее: ранее
свое: своем
призыв: призыве
действие: действиям
борьба: борьбе
антониу: антониу
гутерриш: гутерриш
земля: земля
становиться: становится
жаркий: жарче
везде: везде
оценка: оценкам
период: период
жары: жары
житель: жителей
приходиться: приходилось
процент: процентов
смерть: смертей смерти
потерять: потерянных
защита: защиты защите
подчеркивать: подчеркивают
правительство: правительств
должен: должны
принимать: принимать
смягчение: смягчению
последствие: последствий последствия
шоковый: шоков
уязвимый: уязвимых
слой: слоев
население: населения
разработать: разработали
подобныепланы: подобныепланы
однако: однако
недостаточно: недостаточно
сообщество: сообществ
читать: читайте
юнисеф: юнисеф
центральный: центральной
убивать: убивает
ребенок: детей
негативный: негативные
здоровье: здоровья
предотвратить: предотвратить
быть: будем
подготовить: подготовлены
потепление: потеплению
спасти: спасем
множество: множество
прямой: прямо
будущее: будущем
заявить: заявил
защититься: защититься
опасность: опасностей
повышение: повышением
рекомендовать: рекомендует
избегать: избегать избегайте
выходить: выходите
улица: улицу
заниматься: занимайтесь
активный: активной
деятельность: деятельностью
сам: самое
сутки: суток
оставаться: оставайтесь
тень: тени
оставлять: оставляйте
припарковать: припаркованных
машина: машинах
нужно: нужно
выйти: выйти
дома: дома
стараться: старайтесь
проводить: проводить
какой-то: какое-то
охлаждать: охлаждаемых
помещение: помещений
например: например
зайти: зайдите
супермаркет: супермаркет
поддерживать: поддерживать
прохлада: прохладу
дом: доме
уменьшить: уменьшите
тепловой: тепловую
нагрузка: нагрузку
течение: течение
день: дня
использовать: используя использовать
жалюзи: жалюзи
ставень: ставни
носить: носить
легкий: легкую
свободный: свободную
одежда: одежду
легкое: легкое
постельный: постельное
белье: белье
прохладный: прохладный
душ: душ
ванна: ванну
регулярно: регулярно
пить: пить
вод: воду
сладкое: сладких
алкогольный: алкогольных
напиток: напитков
кофеин: кофеином
мочь: могут
привести: привести
обезвоживание: обезвоживанию
заботиться: заботиться
проверять: проверяйте
чувствовать: чувствуют
друг: друзья
сосед: соседи
внимание: внимания
один: одни
подписываться: подписывайтесь
наш: нашу наши
рассылка: рассылку
загружать: загружайте
приложение: приложение
мобильный: мобильных
устройство: устройств
глава: глава
тройной: тройной
экологический: экологический
приводить: приводит
преждевременный: преждевременной
подготовиться: подготовиться
лето: лету
рекомендация: рекомендации
вмо: вмо
превысить: превысить
доиндустриальный: доиндустриальный
градус: градуса
ресурс: ресурсы
информация: информация
партнер: партнеров
новостной: новостные
анонс: анонсы
журнал: журнал
отчет: отчеты
заседание: заседаниях
аудиовизуальный: аудиовизуальные
материал: материалы
общение: общение
твиттер: твиттер
последний: последние
главное: главные
брифинг: брифингов
стенограмма: стенограммы
комментарий: комментарии
журналист: журналистов
интернет: интернете
фейсбук: фейсбук
вконтакте: вконтакте
контакт: контакты
пользоваться: пользоваться
сайт: сайтом
указатель: указатель
часто: часто
задавать: задаваемые
вопрос: вопросы
остерегаться: остерегайтесь
мошенничество: мошенничества
конфиденциальность: конфиденциальность
условие: условия
пользование: пользования
пожертвование: пожертвования