газ: газа газе газы газу
второй: вторая
фаза: фаза фазы
кампания: кампании
вакцинация: вакцинации
полиомиелит: полиомиелита полиомиелит
начаться: началась
юг: юге
сектор: сектора сектор секторе
новость: новости
оон: оон
перейти: перейти
основное: основному
добро: добро
пожаловать: пожаловать
русский: русский
другой: другие
глобальный: глобальный глобальную
взгляд: взгляд
человеческий: человеческие
судьба: судьбы
поиск: поиск
расширить: расширенный
язык: язык
меню: меню
главный: главная
азия: азия
америка: америка
африка: африка африке
ближний: ближний ближнему
восток: восток востоку
европа: европа
тема: темы теме
гуманитарный: гуманитарная гуманитарные гуманитарных гуманитарной гуманитарном гуманитарного
помощь: помощь помощи
беженец: беженцы беженцев
мигрант: мигранты
женщина: женщины
здравоохранение: здравоохранение здравоохранения
климат: климат
окружать: окружающая
среда: среда среду
культура: культура
образование: образование
международный: международное международным международных международные
правый: право права
мир: мир мира
безопасность: безопасность
генеральный: генеральный генерального
секретарить: секретарь секретаря
человек: человека людей
цель: цели целью
устойчивый: устойчивого
развитие: развития развитие
экономический: экономическое
подробный: подробнее
интервью: интервью
сюжет: сюжеты
экспресс-новости: экспресс-новости
фоторепортаж: фоторепортажи
пресс-секретарь: пресс-секретарь
выступление: выступления
заявление: заявления заявлению заявлении
пресса: прессой
официальный: официальные
поездка: поездки
фотография: фотографии
пресс-релиз: пресс-релизы
группа: группа
аккредитация: аккредитации
сми: сми
интернет-трансляция: интернет-трансляция
аудиотека: аудиотека
подписаться: подписаться
бапор: бапор
ребенок: дети детей детям ребенок
показывать: показывают
окрасить: окрашенные
палец: пальцы
который: которые который
означать: означают
получить: полученную получили
прививка: прививку прививки
печать: печать
сентябрь: сентября
усилие: усилия усилий
переместиться: переместились
четверг: четверг
южный: южные
район: районы районах
анклав: анклава анклаве
этап: этапа этапе этап
проходить: проходит
являться: является
иммунизация: иммунизация иммунизации
примерный: примерно
тысяча: тысяч
возраст: возрасте
десять: десяти
год: лет
сегодня: сегодня
сообщать: сообщают
учреждение: учреждения
утро: утром
команда: команды командам
находиться: находятся
хан-юнисе: хан-юнисе
работать: работают
партнер: партнерами партнеры партнеров
предоставить: предоставить
вакцина: вакцины
это: это
критически: критически
важный: важное важную
время: время
необходимо: необходимо
соблюдать: соблюдать
пауза: паузы
боев: боевых
действие: действиях
этот: этих
защита: защиты
семья: семей
работник: работников
говориться: говорится
публикация: публикации
агентство: агентства
дело: делам
палестинский: палестинских палестинской палестинские
платформа: платформе
успех: успех
первый: первой первую первый
успешный: успешное
проведение: проведение
первое: первого
центральный: центральной
частить: части
кульминация: кульминацией
огромный: огромных
координация: координации
различный: различными
включать: включая
донор: доноров
инициатива: инициативы
ликвидация: ликвидации
подчеркивать: подчеркивает
важность: важность
здоровье: здоровья
благополучие: благополучия
сказать: сказал
представитель: представитель
всемирный: всемирной
организация: организации
воз: воз
оккупировать: оккупированной
территория: территории
рика: рик
пиперкорн: пиперкорн
ранее: ранее
неделя: неделе
провести: провели
специальный: специальные
миссия: миссии
предел: пределами
зона: зоны
убедиться: убедиться
остаться: остался
связь: связи
значительный: значительное
число: число
смочь: смогли
добраться: добраться
пункт: пунктов
отсутствие: отсутствия
безопасный: безопасных
условие: условий условием условия
прийтись: пришлось
посетить: посетить
аль-магази: аль-магази
аль-бурейдж: аль-бурейдж
аль-муссадер: аль-муссадер
доза: дозу
ход: ходе
прошедший: прошедшей
охват: охват
превысить: превысил
первоначальный: первоначальный
целевой: целевой
показатель: показатель
перемещение: перемещением
население: населения населению
центр: центр центров центра
расширение: расширением
журналист: журналисты журналистов
комиссар: комиссар
филипп: филипп
лазарини: лазарини
заявить: заявил
месяц: месяцев
запретить: запрещен
свободный: свободный
въезд: въезд
оттуда: оттуда
репортаж: репортажей
кризис: кризисе
последствие: последствиях
война: войны
освещать: освещать
конфликт: конфликты конфликта
норма: норма
написать: написал
свой: своей
страница: странице
слово: словам
глава: главы глава
вызывать: вызывают
восхищение: восхищение
продолжать: продолжают
работа: работу работе
несмотря: несмотря
большой: большое
коллега: коллег
убить: убиты
корреспондент: корреспонденты
нуждаться: нуждаются
поддержка: поддержке
добавить: добавил
присутствие: присутствие
обязательный: обязательным
независимый: независимого
освещение: освещения
потребность: потребностей
масштабный: масштабных
призвать: призвал
новостной: новостные
оказывать: оказывать
больший: большее
давление: давление
мочь: могли
въехать: въехать
свободно: свободно
событие: события
подписываться: подписывайтесь
наш: нашу наши
рассылка: рассылку
загружать: загружайте
приложение: приложение
мобильный: мобильных
устройство: устройств
удар: удар
один: одному
приказ: приказы
эвакуация: эвакуации
угрожать: угрожают
завершиться: завершился
последний: последние
день: дня
стать: стали
редкий: редкой
белый: белой
полоса: полосой
фон: фоне
катастрофический: катастрофического
опубликовать: опубликованном
региональный: регионального
директор: директора
детский: детского
фонд: фонда
юнисеф: юнисеф
северный: северной
адель: адель
ходр: ходр
завершение: завершением
ресурс: ресурсы
информация: информация
анонс: анонсы
журнал: журнал
отчет: отчеты
заседание: заседаниях
аудиовизуальный: аудиовизуальные
материал: материалы
общение: общение
твиттер: твиттер
главное: главные
брифинг: брифингов
стенограмма: стенограммы
комментарий: комментарии
интернет: интернете
фейсбук: фейсбук
вконтакте: вконтакте
контакт: контакты
пользоваться: пользоваться
сайт: сайтом
указатель: указатель
часто: часто
задавать: задаваемые
вопрос: вопросы
остерегаться: остерегайтесь
мошенничество: мошенничества
конфиденциальность: конфиденциальность
пользование: пользования
пожертвование: пожертвования