воз: воз
тревога: тревогу
связь: связи
беспрецедентный: беспрецедентным беспрецедентный
рост: ростом
число: числа число числе
случай: случаев случаями случаи
заболевание: заболевания заболеванием заболевание заболеваний
оспа: оспой оспы оспа оспу
обезьяна: обезьян
африка: африке африка африки африку
новость: новости
оон: оон
перейти: перейти
основное: основному
добро: добро
пожаловать: пожаловать
русский: русский
другой: другие
глобальный: глобальный
взгляд: взгляд
человеческий: человеческие
судьба: судьбы
поиск: поиск
расширить: расширенный
язык: язык
меню: меню
главный: главная
азия: азия
америка: америка
ближний: ближний ближайшее
восток: восток
европа: европа
тема: темы теме
гуманитарный: гуманитарная гуманитарными
помощь: помощь
беженец: беженцы
мигрант: мигранты
женщина: женщины
здравоохранение: здравоохранение здравоохранения
климат: климат
окружать: окружающая
среда: среда
культура: культура
образование: образование
международный: международное международного
правый: право права
мир: мир мира
безопасность: безопасность
генеральный: генеральный генерального
секретарить: секретарь секретаря
человек: человека люди человеком человеку
цель: цели целью
устойчивый: устойчивого
развитие: развития развитие
экономический: экономическое
подробный: подробнее
интервью: интервью
сюжет: сюжеты
экспресс-новости: экспресс-новости
фоторепортаж: фоторепортажи
пресс-секретарь: пресс-секретарь
выступление: выступления
заявление: заявления
пресса: прессой
официальный: официальные
поездка: поездки
фотография: фотографии
пресс-релиз: пресс-релизы
группа: группа группы
аккредитация: аккредитации
сми: сми
интернет-трансляция: интернет-трансляция
аудиотека: аудиотека
подписаться: подписаться
частица: частицы
вирус: вируса вирусом
красный: красного
цвет: цвета
инфицированный: инфицированной инфицированными
клетка: клетки
синий: синяя
печать: печать
август: августа
всемирный: всемирная
организация: организация
повысить: повысила
уровень: уровень
реагирование: реагирования
вспышка: вспышку вспышках вспышками вспышка
десять: десяти
африканский: африканских африканском
страна: странах стран странам
сам: самого самое
высокий: высокого
значение: значения
предполагать: предполагает
мобилизация: мобилизацию
усилие: усилий
агентство: агентства
борьба: борьбу борьбе
это: этим
январь: января
континент: континенте
наблюдаться: наблюдается
слово: словам
специалист: специалистов
всплеск: всплеск
сообщить: сообщили
дать: данным данном
четверг: четверг
начало: начала
год: года год
подтвердить: подтверждено
заражение: заражения
смерть: смертей смертями
сравнение: сравнению
семью: семью
весить: весь
вызывать: вызываемое
который: который которые
относиться: относится
род: роду
типичный: типичными
симптом: симптомами
являться: являются является
кожный: кожная
сыпать: сыпь
поражение: поражение
слизистая: слизистых
оболочка: оболочек
мочь: могут
длиться: длиться
протяжение: протяжении
двух-четырех: двух-четырех
неделя: недель
сопровождаться: сопровождаться
лихорадка: лихорадкой
головной: головной
боль: болью болями
мышца: мышцах
спина: спине
слабость: слабостью
увеличение: увеличением
лимфатический: лимфатических
узел: узлов
заразиться: заразиться
физический: физическом
контакт: контакте контакты
заразный: заразным
загрязненный: загрязненными
предмет: предметами
животное: животными животных
большой: наибольшее
процент: процентов
зарегистрировать: зарегистрированных зарегистрированы
приходиться: приходится
демократический: демократическую
республика: республику
конго: конго
включать: включая
новый: новый
вариант: вариант вариантом
появиться: появившийся
сентябрь: сентябре
прошлый: прошлого
соседний: соседних
руанда: руанде
уганда: уганде
также: также
кения: кении
анализ: анализ
бурунди: бурунди
продолжаться: продолжается
матсидисо: матсидисо
моети: моети
региональный: региональный
директор: директор
подчеркнуть: подчеркнул
приоритетный: приоритетной
задача: задачей
этап: этапе
немедленный: немедленное
прерывание: прерывание
распространение: распространения распространение
работать: работаем работает
партнер: партнерами партнеров
усиление: усилением
мера: мер
сказать: сказал
работа: работа
место: местах
страновой: страновые
команда: команды
эксперт: экспертов эксперты
развернуть: развернутые
поддержка: поддержки
власть: властей
укрепление: укреплении
ключевой: ключевых
область: областей
эпидемический: эпидемического
надзор: надзора
диагностический: диагностического
тестирование: тестирования
клинический: клинического
уход: ухода
профилактика: профилактики
кроме: кроме
совместно: совместно
национальный: национальными
орган: органами
органиазция: органиазция
заниматься: занимается
обеспечение: обеспечением
доступ: доступа
терапевтический: терапевтическим
препарат: препаратам
активизация: активизацией
повышение: повышению
осведомленность: осведомленности
население: населения
опасность: опасности
оценка: оценка
риск: риска
глава: глава
тедрос: тедрос
адханом: адханом
гебрейесус: гебрейесус
созвать: созвал
экстренный: экстренное
совещание: совещание
комитет: комитета комитет
определить: определить
чрезвычайный: чрезвычайной
ситуация: ситуацией
собраться: соберется
время: время
состав: состав
войти: войдут
независимый: независимые
целый: целому
ряд: ряду
дисциплина: дисциплин
выступать: выступая
женева: женеве
подписываться: подписывайтесь
наш: нашу наши
рассылка: рассылку
загружать: загружайте
приложение: приложение
мобильный: мобильных
устройство: устройств
помогать: помогает
выявлять: выявлять
предотвращать: предотвращать
расти: растет
передаваться: передающихся
смочь: сможет
победить: победить
должен: должна
поддержать: поддержать
вакцина: вакцинами
ресурс: ресурсы
информация: информация
новостной: новостные
анонс: анонсы
журнал: журнал
отчет: отчеты
заседание: заседаниях
аудиовизуальный: аудиовизуальные
материал: материалы
общение: общение
твиттер: твиттер
последний: последние
главное: главные
брифинг: брифингов
стенограмма: стенограммы
комментарий: комментарии
журналист: журналистов
интернет: интернете
фейсбук: фейсбук
вконтакте: вконтакте
пользоваться: пользоваться
сайт: сайтом
указатель: указатель
часто: часто
задавать: задаваемые
вопрос: вопросы
остерегаться: остерегайтесь
мошенничество: мошенничества
конфиденциальность: конфиденциальность
условие: условия
пользование: пользования
пожертвование: пожертвования