европейский: европейское европейском европейского европейский
бюро: бюро
воз: воз
представить: представило
обновить: обновленные
дать: данные данным
курение: курению курением курения курение
регион: регионе региона регион
новость: новости
оон: оон
перейти: перейти
основное: основному
добро: добро
пожаловать: пожаловать
русский: русский
другой: другие
глобальный: глобальный глобального
взгляд: взгляд
человеческий: человеческие
судьба: судьбы
поиск: поиск
расширить: расширенный
язык: язык
меню: меню
главный: главная
азия: азия азии
америка: америка
африка: африка
ближний: ближний
восток: восток
европа: европа европы
тема: темы теме
гуманитарный: гуманитарная
помощь: помощь
беженец: беженцы
мигрант: мигранты
женщина: женщины
здравоохранение: здравоохранение здравоохранения
климат: климат
окружать: окружающая
среда: среда
культура: культура
образование: образование
международный: международное
правый: право права
мир: мир мире
безопасность: безопасность
генеральный: генеральный генерального
секретарить: секретарь секретаря
человек: человека людей
цель: цели
устойчивый: устойчивого
развитие: развития развитие
экономический: экономическое
подробный: подробнее
интервью: интервью
сюжет: сюжеты
экспресс-новости: экспресс-новости
фоторепортаж: фоторепортажи
пресс-секретарь: пресс-секретарь
выступление: выступления
заявление: заявления
пресса: прессой
официальный: официальные
поездка: поездки
фотография: фотографии
пресс-релиз: пресс-релизы
группа: группа
аккредитация: аккредитации
сми: сми
интернет-трансляция: интернет-трансляция
аудиотека: аудиотека
подписаться: подписаться
мремес: мремес
употребление: употреблением употребление употребления
табак: табака табак
страна: странах страны стран стране
связанный: связаны связанные
процент: процентов проценте процентах
смерть: смертей смерти
неинфекционный: неинфекционных
заболевание: заболеваний заболевания
печать: печать
декабрь: декабря
оценка: оценкам оценки
всемирный: всемирной
организация: организации
настоящее: настоящее
время: время
употреблять: употребляют
миллион: миллионов миллиона
взрослый: взрослых
подростковый: подростков
возраст: возрасте
год: лет год году года
каждый: каждый
государствах-членах: государствах-членах
входить: входят
центральный: центральной
израиль: израиль
становиться: становятся
причина: причиной причин
являться: является
один: одной
основной: основных
инвалидность: инвалидности
такой: таких таким
сердечно-сосудистый: сердечно-сосудистые
рак: рак
хронический: хронические
респираторный: респираторные
это: это
общепризнанный: общепризнанный
факт: факт
несмотря: несмотря
многие: многих
мера: меры
политик: политики политике политикам
область: области
недостаточно: недостаточно
эффективный: эффективны эффективные
защитить: защитить
здоровье: здоровье здоровья
сказать: сказал
представитель: представитель
гален: гален
галеа: галеа
слово: словам
высокий: высокая высокими
распространенность: распространенность распространенности
подпитываться: подпитывается
мощный: мощным
влияние: влиянием
табачный: табачной табачных табачные
индустрия: индустрии
агрессивный: агрессивными
прием: приемами
маркетинг: маркетинга
пробел: пробелами
антитабачный: антитабачной
который: которые
подрывать: подрывают
усилие: усилия
охрана: охране
население: населения населению
начать: начнем
действовать: действовать
по-новому: по-новому
наш: наш нашу наши
занимать: занимать
первое: первое
место: место местах
потребление: потребления потребление
добавить: добавил
неоднозначный: неоднозначный
прогресс: прогресс
последний: последним последние
достигнуть: достигли
хороший: хороших
результат: результатов
два: двух
ключевой: ключевых
аспект: аспектах
мониторинг: мониторинге мониторинга
предупреждение: предупреждении предупреждению
опасность: опасности
существовать: существуют
надежный: надежные
система: системы
изделие: изделий изделия
эффективность: эффективности
приниматься: принимаются
риск: рисках
облагаться: облагаются
налог: налогами
период: период
ценовой: ценовая
доступность: доступность
сигарета: сигарет сигаретам
снизиться: снизилась снизится
лишь: лишь
шесть: шести
интерес: интересах
следовать: следует
рассмотреть: рассмотреть
возможность: возможность
повышение: повышения
налоговый: налогов
образ: образом
цена: цена
опережать: опережала
рост: рост
доход: доходов
подчеркнуть: подчеркнули
предоставляться: предоставляется
достаточный: достаточная
поддержка: поддержка
отказ: отказа
государство: государств
принять: приняли
комплексный: комплексное
законодательство: законодательство
запрет: запрете
общественный: общественных
полностью: полностью
запретить: запретили
реклама: рекламу
стимулирование: стимулирование
продажа: продаж
прогноз: прогноз
будущее: будущее
рамка: рамках
план: плана
действие: действий
обязаться: обязались
снизить: снизить
однако: однако
число: числе
туркменистан: туркменистан
планомерно: планомерно
двигаться: движутся
достижение: достижению
предполагаться: предполагается
большинство: большинстве
менее: менее
запланировать: запланированные
вызывать: вызывает
беспокойство: беспокойство
едва: едва
смочь: смогут
добиться: добиться
какой-либо: каких-либо
значительный: значительных
изменение: изменений
молдова: молдове
показатель: показатели
увеличиться: увеличатся
подписываться: подписывайтесь
рассылка: рассылку
загружать: загружайте
приложение: приложение
мобильный: мобильных
устройство: устройств
снижаться: снижается
молодая: молодые
житель: жители
стать: стали
маленький: меньше
курить: курить
пристраститься: пристрастились
электронный: электронным
минздрав: минздрав
россия: россии
наградить: награжден
медаль: медалью
борьба: борьбу
ресурс: ресурсы
информация: информация
партнер: партнеров
новостной: новостные
анонс: анонсы
журнал: журнал
отчет: отчеты
заседание: заседаниях
аудиовизуальный: аудиовизуальные
материал: материалы
общение: общение
твиттер: твиттер
главное: главные
брифинг: брифингов
стенограмма: стенограммы
комментарий: комментарии
журналист: журналистов
интернет: интернете
фейсбук: фейсбук
вконтакте: вконтакте
контакт: контакты
пользоваться: пользоваться
сайт: сайтом
указатель: указатель
часто: часто
задавать: задаваемые
вопрос: вопросы
остерегаться: остерегайтесь
мошенничество: мошенничества
конфиденциальность: конфиденциальность
условие: условия
пользование: пользования
пожертвование: пожертвования