воз: воз
опубликовать: опубликовала
новый: новый новую
доклад: доклад докладе
состояние: состоянии
здоровье: здоровья здоровьем
население: населения
европейский: европейском европейский европейское европейского европейская
регион: регионе регион региону региона
новость: новости
оон: оон
перейти: перейти
основное: основному
добро: добро
пожаловать: пожаловать
русский: русский
другой: другие другими
глобальный: глобальный
взгляд: взгляд
человеческий: человеческие
судьба: судьбы
поиск: поиск
расширить: расширенный
язык: язык
меню: меню
главный: главная главный главной
азия: азия азии азией
америка: америка
африка: африка
ближний: ближний
восток: восток
европа: европа европы европе европой
тема: темы теме
гуманитарный: гуманитарная
помощь: помощь
беженец: беженцы
мигрант: мигранты
женщина: женщины
здравоохранение: здравоохранение здравоохранения
климат: климат
окружать: окружающая
среда: среда
культура: культура
образование: образование
международный: международное
правый: право права
мир: мир мире миру
безопасность: безопасность
генеральный: генеральный генерального
секретарить: секретарь секретаря
человек: человека человек люди людей
цель: цели
устойчивый: устойчивого
развитие: развития развитие
экономический: экономическое
подробный: подробнее
интервью: интервью
сюжет: сюжеты
экспресс-новости: экспресс-новости
фоторепортаж: фоторепортажи
пресс-секретарь: пресс-секретарь
выступление: выступления
заявление: заявления
пресса: прессой
официальный: официальные
поездка: поездки
фотография: фотографии
пресс-релиз: пресс-релизы
группа: группа
аккредитация: аккредитации
сми: сми
интернет-трансляция: интернет-трансляция
аудиотека: аудиотека
подписаться: подписаться
фото: фото
панамериканский: панамериканской
организация: организации
демпстер: демпстер
последний: последние последнем последнее последних
год: годы лет году год годом года
отмечаться: отмечалась отмечается
стагнация: стагнация
показатель: показателей показателями показатели показатель
вакцинация: вакцинации
печать: печать
февраль: февраля
ежегодно: ежегодно
умирать: умирают умирает
тысяча: тысяч
ребенок: детей ребенок
возраст: возрасте возраста
пять: пяти пять
каждый: каждый каждого
шестая: шестой
неинфекционный: неинфекционных неинфекционные неинфекционными
заболевание: заболеваний заболевания заболеваниями
низ: низ
сообщаться: сообщается
основать: основанном
дать: данных
все: всем всему всеми
страна: странам странами стран странах стране
центральный: центральной
несмотря: несмотря
прогресс: прогресс
некоторые: некоторых
область: областях
который: который которого
долгий: долгое
время: время
считаться: считался
один: одним одни одной
самый: самых самый самые
сильный: сильных
сфера: сфере
наблюдаться: наблюдалась наблюдаются
откат: откат
целый: целому целом
ряд: ряду
подростковый: подростков
хронический: хронических
детская: детская детской
смертность: смертность смертности
разница: разница
огромный: огромна
низкий: низких низкие
хороший: наилучшими
плохой: худшими плохого
составлять: составляет
смерть: смертей смерти
анализ: анализ
иметься: имеющихся
государство: государствах государствами
показывать: показывает
умереть: умерли
достигнуть: достигнув достигли
пятилетнего: пятилетнего
основной: основных основной
причина: причин причиной причинами
осложнение: осложнения
преждевременный: преждевременных
роды: родах
асфиксия: асфиксия
рождение: рождении
врожденный: врожденные
аномалия: аномалии
сердце: сердца
инфекция: инфекции
нижний: нижних
дыхательный: дыхательных
путь: путей
неонатальный: неонатальный
сепсис: сепсис
проблема: проблемы проблемам
психический: психическим психического
говориться: говорится
пятый: пятого
подросток: подростка подросток
процент: процентов процента
сообщать: сообщают
подвергаться: подвергались
кибербуллингу: кибербуллингу
девочка: девочки
низок: низком
уровень: уровне уровень
благополучие: благополучия
сравнение: сравнению
мальчик: мальчиками
самоубийство: самоубийство
являться: является
лицо: лиц
десятый: десятый
употреблять: употребляет
какой-либо: какую-либо
форма: форму
табачный: табачных
изделие: изделий
включать: включая
электронный: электронные
сигарета: сигареты
треть: треть трети
школьный: школьного
иметь: имеет
избыточный: избыточный
вес: вес
восьмой: восьмой
страдать: страдает страдали
ожирение: ожирения
маркетинг: маркетинг маркетинга
продукт: продуктов
высокий: высоким выше высокий высокие высокими
содержание: содержанием
соль: соли
жир: жира
сахар: сахара
оказывать: оказывает
негативный: негативное
влияние: влияние
модель: модели
питание: питания
вести: ведет
долгосрочный: долгосрочным
менее: менее
большинство: большинстве
по-прежнему: по-прежнему
механизм: механизмов
защита: защиты
агрессивный: агрессивного
вредный: вредных
наш: нашем нашу наши
онлайн-мире: онлайн-мире
взаимосвязанный: взаимосвязаны
молодая: молодые
ирония: иронии
чувствовать: чувствуют
одинокий: одинокими
когда-либо: когда-либо
прежде: прежде
многие: многих
лишний: лишним
весомый: весом
уверенность: уверенностью
сказать: сказал
ханс: ханс
клюге: клюге
региональный: региональный регионального
директор: директор
убийца: убийца
добиться: добился
больший: больших
успех: успехов успехи
борьба: борьбе
крайний: крайней
мера: мере
сокращение: сокращению
число: числа число
четыре: четырех
сердечно-сосудистый: сердечно-сосудистых сердечно-сосудистые
рак: рака рак раком
диабет: диабета
респираторный: респираторных
приходиться: приходится
риск: риск
восточный: восточной
западный: западной
употребление: употребление употребления
алкоголь: алкоголя алкоголь
курение: курение курения
потребление: потребления
средний: среднем
литровый: литров
чистый: чистого
взрослый: взрослого взрослых
настоящее: настоящее
спиртное: спиртных
напиток: напитков
регистрироваться: регистрируются регистрируется
союз: союзе
табак: табака
также: также
оставаться: остаются
приблизиться: приблизился
достижение: достижению
получать: получают
внимание: внимания
заслуживать: заслуживают
отметить: отметил отметили
интересно: интересно
заболеваемость: заболеваемость
северный: северной
распространить: распространены
добавить: добавил
подчеркнуть: подчеркнул
должен: должен
бороться: бороться
загрязнение: загрязнения
воздух: воздуха
отсутствие: отсутствия
физический: физической
активность: активности
ситуация: ситуацию
усугублять: усугубляет
климатический: климатический
кризис: кризис
стремительно: стремительно
теплеть: теплеет
температура: температура
расти: растет
примерный: примерно
раз: раза
быстрый: быстрее
оценка: оценкам
связанный: связанных связано
жара: жарой
вспышка: вспышки
корь: кори
это: это
частность: частности
кампания: кампаниями
дезинформация: дезинформации
результат: результате
зарегистрировать: зарегистрировано
случай: случаев
ранее: ранее
туберкулез: туберкулез туберкулезом
вич: вич
отмечать: отмечают
снизиться: снизилась снизилось
период: период
миллион: миллиона миллионов
жить: живут
диагностировать: диагностированных
вич-инфекция: вич-инфекции
инфицированный: инфицированных
знать: знают
свое: своем
статус: статусе
антиретровирусную: антиретровирусную
терапия: терапию
деменция: деменция
инвалидность: инвалидности
пожилой: пожилых
несколько: несколько
десятилетие: десятилетий
резкий: резко
возрасти: возросла
доля: доля
вызвать: вызванных
болезнь: болезнью
альцгеймера: альцгеймера
вид: видами
деменции: деменции
деменцией: деменцией
ожидаться: ожидается
удвоиться: удвоится
далекий: дальше
бюро: бюро
проводить: проводит
консультация: консультации
определение: определения
приоритет: приоритетов
действие: действий
следующий: следующие
конец: конце
октябрь: октября
сессия: сессии
комитет: комитета
принять: принята
второй: вторая
программа: программа
работа: работы
детский: детский
фонд: фонд
юнисеф: юнисеф
представить: представят
стратегия: стратегию
охрана: охраны
подписываться: подписывайтесь
рассылка: рассылку
загружать: загружайте
приложение: приложение
мобильный: мобильных
устройство: устройств
деятельность: деятельность
отрасль: отраслей
промышленность: промышленности
уносить: уносит
жизнь: жизней
болезный: болезней
пьянство: пьянством
ресурс: ресурсы
информация: информация
партнер: партнеров
новостной: новостные
анонс: анонсы
журнал: журнал
отчет: отчеты
заседание: заседаниях
аудиовизуальный: аудиовизуальные
материал: материалы
общение: общение
твиттер: твиттер
главное: главные
брифинг: брифингов
стенограмма: стенограммы
комментарий: комментарии
журналист: журналистов
интернет: интернете
фейсбук: фейсбук
вконтакте: вконтакте
контакт: контакты
пользоваться: пользоваться
сайт: сайтом
указатель: указатель
часто: часто
задавать: задаваемые
вопрос: вопросы
остерегаться: остерегайтесь
мошенничество: мошенничества
конфиденциальность: конфиденциальность
условие: условия
пользование: пользования
пожертвование: пожертвования