теракт: теракта теракты
воз: воз
помогать: помогает помогал помогая помогала помогать
израильский: израильским израильская
спасатель: спасателям
справиться: справиться
психологический: психологическими психологическую психологической психологическая
травма: травмами травм травмы
новость: новости
оон: оон
перейти: перейти
основное: основному
добро: добро
пожаловать: пожаловать
русский: русский
другой: другие другими другим других
глобальный: глобальный
взгляд: взгляд
человеческий: человеческие
судьба: судьбы
поиск: поиск
расширить: расширенный
язык: язык
меню: меню
главный: главная
азия: азия
америка: америка
африка: африка
ближний: ближний
восток: восток
европа: европа
тема: темы теме
гуманитарный: гуманитарная
помощь: помощь помощи помощью
беженец: беженцы
мигрант: мигранты
женщина: женщины
здравоохранение: здравоохранение здравоохранения
климат: климат
окружать: окружающая
среда: среда
культура: культура
образование: образование
международный: международное
правый: право права
мир: мир
безопасность: безопасность безопасности
генеральный: генеральный генерального
секретарить: секретарь секретаря
человек: человека люди людьми людей человек людям человеком
цель: цели
устойчивый: устойчивого
развитие: развития развитие
экономический: экономическое
подробный: подробнее
интервью: интервью
сюжет: сюжеты
экспресс-новости: экспресс-новости
фоторепортаж: фоторепортажи
пресс-секретарь: пресс-секретарь
выступление: выступления
заявление: заявления
пресса: прессой
официальный: официальные
поездка: поездки
фотография: фотографии
пресс-релиз: пресс-релизы
группа: группа группу
аккредитация: аккредитации
сми: сми
интернет-трансляция: интернет-трансляция
аудиотека: аудиотека
подписаться: подписаться
поддержка: поддержке поддержки поддержку
европейский: европейского
бюро: бюро
всемирный: всемирной всемирный
организация: организации организация организаций
машив: машив
ха-руах: ха-руах
проводить: проводит проводить
семинар: семинары семинаров семинарах семинара
формат: формате
ретрита: ретрита
участник: участники участникам участник
который: которых который которые которым которую
мочь: могут могли можете мог могла
комфортный: комфортной
обстановка: обстановке
обсуждать: обсуждать
осмысливать: осмысливать
пережитое: пережитое пережитом
печать: печать
октябрь: октября октябре
год: года лет год годы
назад: назад
израиль: израиль израиле
пережить: пережил пережили пережить
страшный: страшное
террористический: террористическое
нападение: нападение нападений нападениям нападения нападению
житель: жители жителей жителям
страна: страны стране
особенно: особенно
пострадать: пострадавшим пострадавшими пострадавших
сей: сих
пора: пор
переживать: переживают
последствие: последствия
получить: полученных получила получивший получить
психический: психических психического
деть: день
здоровье: здоровья
отмечать: отмечают отмечает
предлагать: предлагаем предлагают
ваш: вашему
внимание: вниманию внимания
материал: материал материалы
подготовить: подготовленный
наш: нашими наших нашей нашего наша нашу наши
коллега: коллегами коллег коллегам коллеги
водитель: водители
машина: машин
скорый: скорой
медицинский: медицинский медицинского медицинском
персонал: персонал персоналом
больница: больниц
прибывать: прибывали
раненый: раненые раненых раненого
оказывать: оказывал оказывает оказывают оказывали
первый: первую
непосредственно: непосредственно
место: месте местах
событие: событий
стать: стали стала
свидетель: свидетелями
ужасный: ужасных
картина: картин
менее: менее
сильный: сильное сильные сильнее
впечатление: впечатление
увидеть: увиденное увидеть
произвести: произвело
тот: тех
поздний: позже
опознавать: опознавать
тело: тела
готовить: готовить
погибнуть: погибших
погребение: погребению
возвращение: возвращение
дух: духа
психиатрический: психиатрическую психиатрической
работник: работникам работников
передовой: передового
звено: звена
самый: самым самых
преодолеть: преодолеть
коллективный: коллективной
вырабатывать: вырабатывать
жизнестойкость: жизнестойкость
формировать: формировать
механизм: механизмы
преодоление: преодоления
стресс: стресса стрессу стрессом
помочь: помогут помочь помогли
жить: жить жили
далекий: дальше
поддерживать: поддерживать
свое: своих свои своими своим
эяль: эяль
кравиц: кравиц
основатель: основатель
исполнительный: исполнительный
директор: директор директора
просматривать: просматривал
видео: видео
работать: работая работал работает работают
невообразимый: невообразимо
сложный: сложных
условие: условиях условия
подумать: подумал подумали
как-то: как-то
иначе: иначе
сам: сами самим саму
нуждаться: нуждаются нуждающихся нуждающемуся
говорить: говорит говорить
решить: решил
создать: создать создали
гражданский: гражданских
лицо: лиц
вместе: вместе
соучредитель: соучредителем соучредитель
даниэль: даниэлем даниэль
шермоном: шермоном
разработать: разработал разработала
план: план
действие: действий
день: дни
предложить: предложило
множество: множество
вспоминать: вспоминает
шермон: шермон
психолог: психолог
веред: веред
ацмон: ацмон
мешулам: мешулам
профессиональный: профессиональной
деятельность: деятельности
один: одна одними одного
такой: такую такие
сразу: сразу
записаться: записалась
волонтер: волонтеры волонтерами волонтером волонтеров
убить: убитых
горе: горем
прийтись: пришлось
близкие: близких
время: время
очень: очень
трудный: трудной трудно
точка: точки
зрение: зрения
работа: работы работе
общаться: общалась
поисково-спасательный: поисково-спасательных поисково-спасательной
первое: первых первые первое
оказываться: оказывались оказывается
подвергнуться: подвергшихся
тяжелый: тяжело тяжелыми
сказаться: сказалось
психика: психике
развиваться: развивались
нарушение: нарушения
бессонница: бессонница
посттравматический: посттравматическое
стрессовый: стрессовое
расстройство: расстройство
депрессия: депрессия
тревога: тревога
также: также
распространиться: распространились
однако: однако
хаос: хаосе
месяц: месяцев месяцы
найтись: нашлось
поддержать: поддержать
этот: этих
восполнить: восполнила
пробел: пробел
начать: начав начать
программа: программу программа
проводиться: проводятся
пустыня: пустыне
вдали: вдали
городской: городского
шум: шума
суета: суеты
групповой: групповых
занятие: занятий занятия
рассказывать: рассказывают рассказывать
знакомиться: знакомятся
друг: друг другом
сеть: сети сеть
контакт: контактов контакты
важный: важные
взаимный: взаимной
сохраняться: сохраняются
окончание: окончания
симптом: симптомов
заключаться: заключается
практический: практически
полный: полной
изоляция: изоляции
это: этим это
кажется: кажется
никто: никто никого
смочь: сможет смогут смогли
понять: понять
жена: женами жены
солдат: солдат
число: числе
центр: центра центр центре
моше: моше
сорока: сороки
привозить: привозили
преодолевать: преодолевать
оставить: оставили
глубокий: глубокие глубокую
рана: раны
душ: душах души душе
израильтянин: израильтян
многие: многим многие
казаться: казалось
нормальный: нормальной
жизнь: жизнью жизнь
чувствовать: чувствовать
хотеть: хотели хотят хотел хотите хочу
довестись: довелось
думать: думал
нужно: нужно
кто-то: кем-то кто-то
поначалу: поначалу
мы: нам
убедить: убедить
приехать: приехать
польза: пользе
ретритов: ретритов
научиться: научиться научился
делиться: делиться делился делится
переживание: переживаниями переживаниях
таль: таль
негосударственный: негосударственной
принимать: принимал
участие: участие
операция: операциях
попасть: попал
обстрел: обстрел
извлекать: извлекать
фестиваль: фестивале
новый: нова
слово: словам
описывать: описывать
выражать: выражать
чувство: чувства чувствах
легкий: легче
рекомендовать: рекомендует
побывать: побывать побывал
ретрите: ретрите
большинство: большинство
говорят: говорят
ответ: ответ
никуда: никуда
идти: идти
начинать: начинаем начинает
проблема: проблемах
разговор: разговор
включаться: включается включаются
весь: вся
представить: представить
атмосфера: атмосферу
комната: комнате
момент: момент
включать: включает
призвать: призванные
осмыслить: осмыслить
свой: свой своей своя
травматический: травматический
опыт: опыт
выработать: выработать
терапевт: терапевты
смысл: смысл
придать: придать
история: истории история
реальность: реальность
что-то: что-то
изменить: изменить
выкинуть: выкинуть
по-другому: по-другому
себя: собой
немного: немного
успокаиваться: успокаиваются
сообщение: сообщение
писать: писала
муж: муж
вернуться: вернулся вернуться
впервые: впервые
ночь: ночь
спать: спал
спокойный: спокойно
ретриты: ретриты
партнер: партнеров
сотрудник: сотрудников сотрудники сотрудника сотрудниками
стремиться: стремясь
широкий: широкую
участница: участниц
ходайя: ходайя
леший: лешем
мать: мать
четверо: четверых
ребенок: детей
супруг: супруга
военнослужащий: военнослужащего
ходить: ходить
встреча: встречи
никакой: никакой
держаться: держалась
семья: семья семьям
община: община общин
повышать: повышать
устойчивость: устойчивость устойчивости
результат: результате
поступить: поступили поступило
расположить: расположенный
газ: газы
часы: часов
отделение: отделение отделения
неотложный: неотложной
пациент: пациентов
ранение: ранениями
потерять: потеряли
родные: родных
район: районах
жертва: жертвами
врач: врача
два: две
медсестра: медсестры
пенсия: пенсии
заместитель: заместитель
дать: дан
шварцфукс: шварцфукс
понимать: понимал понимает
найти: найти
возможность: возможность
они: ими ними
выжить: выжить
перевернуть: перевернуло
глубина: глубине
должен: должен
способ: способ
каждый: каждого каждый каждому
продолжать: продолжает
терапия: терапия
делать: делает
сплотить: сплотило
ранний: раньше
слышать: слышат
рассказ: рассказы
приходить: приходили приходит
кто: кого кому кем
совершенно: совершенно
ожидать: ожидал
айелет: айелет
харрис: харрис
руководитель: руководитель
отдел: отдела
население: населением
кибуцном: кибуцном
движение: движении
активно: активно
кибуцев: кибуцев
вынудить: вынуждены
эвакуироваться: эвакуироваться
выразить: выразить
энергия: энергия
направить: направлена направленной
наружу: наружу
ряд: рядом
едва: едва
ощутить: ощутила
прилив: прилив
сила: сил силы
мой: мои моими
потребность: потребности
оказаться: оказались
комфортно: комфортно
пройти: прошла
я: мной
готовый: готовые
выслушать: выслушать
просто: просто
вернуть: вернуло
спустя: спустя
подвести: подвести
итог: итоги
январь: января
организовать: организованных
принять: приняли
тысяча: тысяча
сюда: сюда
становиться: становятся
посланник: посланниками
сосед: соседям
годовщина: годовщину
встретить: встретить
рабочий: рабочем
сначала: сначала
остаться: остаться
дома: дома
наедине: наедине
воспоминание: воспоминаниями
знать: знаю
некоторые: некоторые
захотеть: захотят
психологически: психологически
замкнуть: замкнуть
круг: круг
поэтому: поэтому
пойти: пойти
туда: туда
быть: буду будут
считать: считает
охотный: охотнее
вначале: вначале
поставить: поставлены
выбор: выбором
бороться: бороться
бежать: бежать
замыкаться: замыкаетесь
держать: держать
ситуация: ситуацию
контроль: контролем
течение: течением
временить: времени
психосоциальной: психосоциальной
хороший: лучших
обстоятельство: обстоятельствах
нужный: нужна
охватить: охватить
гордиться: гордимся
инициатива: инициатива инициативы
единственный: единственный
проект: проект
признание: признание
рекомендация: рекомендации
министерство: министерства
партнерство: партнерство
поистине: поистине
бесценный: бесценно
признательность: признательность
продолжить: продолжил
миссия: миссия
состоять: состоит
находиться: находились
помимо: помимо
получать: получает
нго: нго
мозаика: мозаика
заниматься: занимается
подготовка: подготовкой
использование: использование
влияние: влияния
религиозный: религиозных
лидер: лидеров
еврейский: еврейских
мусульманский: мусульманских
необходимый: необходимую
психолого-психиатрическую: психолого-психиатрическую
сделать: сделать
услуга: услуги
приемлемый: приемлемыми
свести: свести
минимум: минимуму
стигма: стигму
связанный: связанную
обращение: обращением
подписываться: подписывайтесь
рассылка: рассылку
загружать: загружайте
приложение: приложение
мобильный: мобильных
устройство: устройств
обеспечить: обеспечить
квалифицированный: квалифицированную
мом: мом
открыть: открыла
горячий: горячую
линия: линию
оказание: оказания
украина: украины
трансформировать: трансформировать
система: систему
ресурс: ресурсы
информация: информация
новостной: новостные
анонс: анонсы
журнал: журнал
отчет: отчеты
заседание: заседаниях
аудиовизуальный: аудиовизуальные
общение: общение
твиттер: твиттер
последний: последние
главное: главные
брифинг: брифингов
стенограмма: стенограммы
комментарий: комментарии
журналист: журналистов
интернет: интернете
фейсбук: фейсбук
вконтакте: вконтакте
пользоваться: пользоваться
сайт: сайтом
указатель: указатель
часто: часто
задавать: задаваемые
вопрос: вопросы
остерегаться: остерегайтесь
мошенничество: мошенничества
конфиденциальность: конфиденциальность
пользование: пользования
пожертвование: пожертвования