газ: газе газы газа
завершиться: завершился
первый: первый первую
этап: этап этапа этапов
кампания: кампании кампанию кампания
вакцинация: вакцинации вакцинация
полиомиелит: полиомиелита полиомиелит
новость: новости
оон: оон
перейти: перейти
основное: основному
добро: добро
пожаловать: пожаловать
русский: русский
другой: другие
глобальный: глобальный
взгляд: взгляд
человеческий: человеческие
судьба: судьбы
поиск: поиск
расширить: расширенный
язык: язык
меню: меню
главный: главная
азия: азия
америка: америка
африка: африка африке
ближний: ближний ближнему
восток: восток востоку
европа: европа
тема: темы теме
гуманитарный: гуманитарная гуманитарных гуманитарной гуманитарным гуманитарные
помощь: помощь помощи
беженец: беженцы беженцев
мигрант: мигранты
женщина: женщины
здравоохранение: здравоохранение здравоохранения
климат: климат
окружать: окружающая окружающей
среда: среда среду среде
культура: культура
образование: образование
международный: международное международному
правый: право права прав
мир: мир
безопасность: безопасность
генеральный: генеральный генерального
секретарить: секретарь секретаря
человек: человека
цель: цели цель
устойчивый: устойчивого
развитие: развития развитие
экономический: экономическое
подробный: подробнее
интервью: интервью
сюжет: сюжеты
экспресс-новости: экспресс-новости
фоторепортаж: фоторепортажи
пресс-секретарь: пресс-секретарь
выступление: выступления
заявление: заявления заявлении заявлению
пресса: прессой
официальный: официальные
поездка: поездки
фотография: фотографии
пресс-релиз: пресс-релизы
группа: группа
аккредитация: аккредитации
сми: сми
интернет-трансляция: интернет-трансляция
аудиотека: аудиотека
подписаться: подписаться
бапор: бапор
сентябрь: сентября
доза: дозу
прививка: прививки прививках
получить: получили
тысяча: тысяч тысячи
ребенок: детей дети
возраст: возрасте
год: лет год
центральный: центральной центральных
частить: части
печать: печать
последний: последние
день: дня дни
стать: стали
редкий: редкой
белый: белой
полоса: полосой
фон: фоне
катастрофический: катастрофического
конфликт: конфликта
сектор: секторе сектора
говориться: говорится
опубликовать: опубликованном
региональный: регионального
директор: директора директор
детский: детского детский
фонд: фонда фонд
юнисеф: юнисеф
северный: северной
адель: адель
ходр: ходр
связь: связи
завершение: завершением
первое: первого первые
анклав: анклаве анклава
превышать: превышает
поставить: поставленную
ранее: ранее
время: время
наш: наши нашу
команда: команды
продолжать: продолжают
район: районах
вакцина: вакцины
поступать: поступают
медицинский: медицинские
центр: центры
юг: юге
сообщение: сообщении
агентство: агентства
дело: делам
палестинский: палестинских
платформа: платформе
сотрудник: сотрудники
проводить: проводят
встреча: встречи
население: населением
повышение: повышения
осведомленность: осведомленности
начало: началом начала
южный: южных
завтра: завтра
соблюдение: соблюдение
пауза: пауз паузы пауза паузам
слово: словам слове
риск: риск
распространение: распространения распространение
вирус: вируса вирус
предел: пределами
особенно: особенно
соседний: соседних
страна: странах
оставаться: остается
высокий: высоким
история: история
научный: научные
дать: данные данным
показывать: показывают
мы: нам
самый: самым
безопасный: безопасным безопасному
эффективный: эффективным
способ: способом
остановить: остановить
защитить: защитить
являться: является
отметить: отметила
представительница: представительница
всемирный: всемирная всемирной
организация: организация организации
воз: воз
работать: работают
защита: защиту защите
заболевание: заболевания
добавить: добавила
однако: однако
это: это
достигнуть: достигнуто достигли
подчеркнуть: подчеркнула
согласовать: согласованные
конкретный: конкретных
соблюсти: соблюдены
должен: должно должны
продолжаться: продолжаться
протяжение: протяжении
дальнейший: дальнейших
заявить: заявила
регион: региона регионе
очередь: очередь
исполнительный: исполнительный исполнительного
кэтрин: кэтрин
рассел: рассел
свое: своем свои
вступительный: вступительном
сессия: сессии
совет: совета
миллион: миллиона
нуждаться: нуждаются
выжить: выжить
спустя: спустя
жестокий: жестокого
нападение: нападения
израиль: израиль
разрушительный: разрушительной
война: войны
положение: положение
практический: практически
поддаваться: поддается
описание: описанию
израильский: израильские
убить: убиты
взять: взяты
заложник: заложники заложников
вынудить: вынуждены
покинуть: покинуть
дома: дома
широкий: широко
распространить: распространены
голод: голод
острый: острое
недоедание: недоедание
пострадать: пострадали
серьезный: серьезных
нарушение: нарушений
юный: юные
житель: жители
ютиться: ютятся
территория: территории
маленький: меньше
квадратный: квадратных
километр: километров
сторона: стороны сторонам сторонами
немедленно: немедленно
договориться: договориться
надежный: надежном
прекращение: прекращении
огонь: огня
также: также
содействовать: содействовать
немедленный: немедленному
освобождение: освобождению
остаться: оставшихся
соблюдать: соблюдать
обязательство: обязательства
право: праву
необходимый: необходимой
инфраструктура: инфраструктуры
глава: глава
подписываться: подписывайтесь
рассылка: рассылку
загружать: загружайте
приложение: приложение
мобильный: мобильных
устройство: устройств
ситуация: ситуации
все: всем всеми
необходимо: необходимо
отступить: отступить
край: края
пропасти: пропасти
обстрел: обстрелы
бомбардировка: бомбардировки
задерживать: задерживают
север: севере
выявить: выявила
потенциально: потенциально
опасный: опасный
вторник: вторник
продолжиться: продолжилась
предварительный: предварительным предварительной
понедельник: понедельник
вакцинировать: вакцинировано
готовый: готово
август: августа
учреждение: учреждения
договоренность: договоренности
серия: серии
проведение: проведения
массовый: массовой
позволить: позволит
привить: привить
сообщить: сообщила
пятница: пятницу
ресурс: ресурсы
информация: информация
партнер: партнеров
новостной: новостные
анонс: анонсы
журнал: журнал
отчет: отчеты
заседание: заседаниях
аудиовизуальный: аудиовизуальные
материал: материалы
общение: общение
твиттер: твиттер
главное: главные
брифинг: брифингов
стенограмма: стенограммы
комментарий: комментарии
журналист: журналистов
интернет: интернете
фейсбук: фейсбук
вконтакте: вконтакте
контакт: контакты
пользоваться: пользоваться
сайт: сайтом
указатель: указатель
часто: часто
задавать: задаваемые
вопрос: вопросы
остерегаться: остерегайтесь
мошенничество: мошенничества
конфиденциальность: конфиденциальность
условие: условия
пользование: пользования
пожертвование: пожертвования