такой: такое такие таких
всемирный: всемирная всемирной
организация: организация организации организацией
здравоохранение: здравоохранения здравоохранение здравоохранению здравоохранении
почему: почему
важный: важна важнейшую важных важно
новость: новости
оон: оон
перейти: перейти
основное: основному
добро: добро
пожаловать: пожаловать
русский: русский
другой: другие других
глобальный: глобальный глобальных глобальным глобального
взгляд: взгляд
человеческий: человеческие
судьба: судьбы
поиск: поиск
расширить: расширенный
язык: язык
меню: меню
главный: главная
азия: азия
америка: америка америки
африка: африка
ближний: ближний ближайшее
восток: восток
европа: европа
тема: темы теме
гуманитарный: гуманитарная гуманитарных
помощь: помощь помощи помощью
беженец: беженцы
мигрант: мигранты
женщина: женщины
климат: климат климата климатом
окружать: окружающая
среда: среда
культура: культура
образование: образование
международный: международное международную международная
правый: право права
мир: мир миру мире мира
безопасность: безопасность
генеральный: генеральный генерального
секретарить: секретарь секретаря
человек: человека люди человек
цель: цели целях
устойчивый: устойчивого
развитие: развития развитие
экономический: экономическое
подробный: подробнее
интервью: интервью
сюжет: сюжеты
экспресс-новости: экспресс-новости
фоторепортаж: фоторепортажи
пресс-секретарь: пресс-секретарь
выступление: выступления
заявление: заявления
пресса: прессой
официальный: официальные
поездка: поездки
фотография: фотографии
пресс-релиз: пресс-релизы
группа: группа группам
аккредитация: аккредитации
сми: сми
интернет-трансляция: интернет-трансляция
аудиотека: аудиотека
подписаться: подписаться
воз: воз
девочка: девочка
симптом: симптомами
острый: острого
недоедание: недоедания
обезвоживание: обезвоживания
проходить: проходит
лечение: лечение лечения
полевой: полевом
госпиталь: госпитале
юг: юге
газ: газы газа газе
апрель: апреле
год: года году
печать: печать
январь: января
середина: середине
век: века
чума: чума
холера: холера
желтый: желтая
лихорадка: лихорадка
обрушиться: обрушились
который: который котором которая которых которые которыми
пройти: прошел
процесс: процесс
индустриализация: индустриализации
взаимосвязанный: взаимосвязано
подход: подход
стать: стал стала стали
императив: императивом
врач: врачи
ученый: ученые
президент: президенты
премьер-министр: премьер-министры
срочный: срочно
созвать: созвали
париж: париже
санитарный: санитарную
конференция: конференцию
предшественница: предшественницей
известный: известной
это: это
специализированный: специализированное
учреждение: учреждение
объединить: объединенных
нация: наций
область: области
заниматься: занимается
здоровье: здоровьем здоровья здоровье
благополучие: благополучием
население: населения
планет: планеты
работа: работу работа работе
поддерживать: поддерживают
страна: страны странах странам стран
включать: включая
соединить: соединенные
штат: штаты
однако: однако
понедельник: понедельник
вашингтон: вашингтон
объявить: объявил объявили
план: планах планы
выход: выхода
сожалеть: сожалеет
намерение: намерении
выйти: выйти
надеяться: надеемся
пересмотреть: пересмотрят
свое: свое
решение: решение решении решения
заявить: заявил заявив
представитель: представитель представителей
тарик: тарик
ясаревич: ясаревич
подчеркнуть: подчеркнул
играть: играет
ключевой: ключевую ключевой
роль: роль
защита: защите защиту
житель: жителей
американец: американцев
устранять: устраняет
коренной: коренные
причина: причины причиной
заболевание: заболеваний заболевания
помогать: помогает
создавать: создавать
эффективный: эффективные эффективного эффективную эффективной
система: системы
также: также
выявлять: выявляет
чрезвычайный: чрезвычайные чрезвычайных
ситуация: ситуации ситуациях ситуаций
предотвращать: предотвращает
реагировать: реагирует
число: числе
место: местах
служба: службы
попасть: попасть
мочь: могут
управление: управления управлению
координация: координации
вопрос: вопросов вопросы
укгв: укгв
йенс: йенс
лэрке: лэрке
отметить: отметил
жить: живут жить
долгий: дольше
чувствовать: чувствуют
здоровый: здоровыми
счастливый: счастливыми
многий: многом
реагирование: реагирование реагирования
условие: условиях условия
кризис: кризисов кризис
конфликт: конфликтов
вспышка: вспышек вспышках
болезный: болезней
изменение: изменения изменением
принимать: принимает принимать принимают
ответный: ответные
мера: меры мере мер
все: всему всем всеми
быть: будь будут
судан: судан
украина: украина
сотрудник: сотрудники
доставлять: доставляют
вакцина: вакцины вакцин
медикамент: медикаменты
аптечка: аптечки
оборудование: оборудование
самый: самые самых
опасный: опасные
труднодоступный: труднодоступные
район: районы
зафиксировать: зафиксировала
атака: атак
медработник: медработников
пациент: пациентов
больница: больницы больниц
машина: машины
скорый: скорой
территория: территориях
результат: результате результатов
погибнуть: погибли
получить: получили получить
ранение: ранения
бригада: бригады
часто: часто
ехать: едут
туда: туда
решаться: решаются
эвакуировать: эвакуируют
раненый: раненых
оказывать: оказывают
тяжелый: тяжелых
сентябрь: сентябре
команда: команды команда
помочь: помогли
развернуть: развернуть
кампания: кампанию
вакцинация: вакцинации
полиомиелит: полиомиелита
раздирать: раздираемой
война: войной
осадить: осажденной
кризисный: кризисных
эксперт: эксперты
просеивать: просеивают
тысяча: тысячи
информационный: информационных
сообщение: сообщений
научный: научные
статья: статьи
отчет: отчеты
эпиднадзор: эпиднадзору
проверять: проверяя
поступать: поступающие
сигнал: сигналы
угроза: угрозах угрозы
общественный: общественному
птичий: птичьего
грипп: гриппа
мобилизовать: мобилизует
усилие: усилия
сфера: сфере
профилактика: профилактики
выявление: выявления
укреплять: укреплять
потенциал: потенциал потенциала
обеспечивать: обеспечивая
необходимый: необходимым
предоставление: предоставления
широкий: широкого
спектр: спектра
услуга: услуг услугам
прием: приема
роды: родов
травма: травм
ликвидация: ликвидация ликвидации
забытый: забытые
инфекционный: инфекционные
трансмиссивный: трансмиссивные
болезнь: болезни
инфекция: инфекции
передаваться: передающиеся
половой: половым
путем: путем
передавать: передаваемые
мать: матери
ребенок: ребенку
предотвратить: предотвратить
бороться: бороться
этот: этими
недуг: недугами
поставлять: поставляя
лекарственный: лекарственные
средство: средства
медицинский: медицинское
работать: работая работают работает
создание: созданием
укрепление: укреплением укрепление
лабораторный: лабораторного
диагностик: диагностики
государства-члены: государства-члены
достигнуть: достигли достигла
ряд: ряда ряд
серьезный: серьезных
проблема: проблем проблемами
семь: семь
бразилия: бразилия
вьетнам: вьетнам
индий: индия
иордания: иордания
пакистан: пакистан
тимор-лешти: тимор-лешти
чад: чад
ликвидировать: ликвидировали ликвидирована
целый: целый целей
проказа: проказу
трахома: трахому
передача: передача передачи
вич: вич
сифилис: сифилиса
белиз: белизе
ямайка: ямайке
сент-винсент: сент-винсенте
гренадины: гренадинах
намибия: намибия
веха: вехи
путь: пути
элиминация: элиминации
гепатит: гепатита
сыграть: сыграла
оспа: оспы
полный: полном
искоренение: искоренении
возннуйя: возннуйя
цифровой: цифровое цифрового
сегодня: сегодня
осваивать: осваивает
новый: новые новых новое
рубеж: рубежи
использование: использование использовании
искусственный: искусственного искусственный
интеллект: интеллекта интеллект
влияние: влияние
технология: технологий
продолжать: продолжает
расти: расти
обеспечение: обеспечением
безопасный: безопасного
применение: применения
октябрь: октябре
прошлый: прошлого
опубликовать: опубликовала
руководство: руководство
затрагиваться: затрагиваются
минимизация: минимизация
риск: рисков риски
различный: различных различным
неэтичный: неэтичный
сбор: сбор
дать: данных
кибербезопасности: кибербезопасности
распространение: распространение
предвзятый: предвзятого
отношение: отношения
дезинформация: дезинформации
борьба: борьба
связанный: связанными связанный связанные
затрагивать: затрагивает
оценка: оценкам
миллиард: миллиарда миллиардов миллиард
половина: половину
загрязнение: загрязнение
воздух: воздуха
экстремальный: экстремальные
погодный: погодные
явление: явления
лесной: лесные
пожар: пожары
волна: волны
жары: жары
наводнение: наводнения
миллион: миллионов
смерть: смертей
оказать: оказав
огромный: огромное
давление: давление
оценивать: оценивать
гражданин: граждан
потепление: потеплением
разрабатывать: разрабатывать
последствие: последствий
адаптация: адаптации
сектор: секторах
влиять: влияющих
водный: водные
ресурс: ресурсы
продовольствие: продовольствие
фото: фото
возп: возп
футфенг: футфенг
готовность: готовность
пандемия: пандемиям пандемий пандемия пандемией
всеобщий: всеобщий всеобщее
доступ: доступ доступом
настоящее: настоящее
время: время
возглавлять: возглавляет
заключение: заключению
договор: договора
направить: направленного
достижение: достижением
три: трех
должен: должен
беспрепятственно: беспрепятственно
пользоваться: пользоваться
поправить: поправить
руководить: руководит
агентство: агентство
базироваться: базирующееся
женева: женеве
тедрос: тедрос
адханом: адханом
гебрейесус: гебрейесус
директивный: директивный
орган: орган
ассамблея: ассамблея
состоять: состоит
государств-членов: государств-членов
ежегодно: ежегодно
проводить: проводят
совещание: совещания
согласование: согласования
приоритет: приоритетов
политик: политики
стратегия: стратегиях
руководствоваться: руководствоваться
свой: своей
совместный: совместной
секретариат: секретариате
один: одна
реформа: реформа
призвать: призвана
сделать: сделать
подписываться: подписывайтесь
наш: нашу наши
рассылка: рассылку
загружать: загружайте
приложение: приложение
мобильный: мобильных
устройство: устройств
выпустить: выпустила
этика: этике
маленький: меньше
болеть: болеть
перечеркнуть: перечеркнуть
достигнутый: достигнутые
успех: успехи
наладить: наладить
обслуживание: обслуживание
менее: менее
информация: информация
партнер: партнеров
новостной: новостные
анонс: анонсы
журнал: журнал
заседание: заседаниях
аудиовизуальный: аудиовизуальные
материал: материалы
общение: общение
твиттер: твиттер
последний: последние
главное: главные
брифинг: брифингов
стенограмма: стенограммы
комментарий: комментарии
журналист: журналистов
интернет: интернете
фейсбук: фейсбук
вконтакте: вконтакте
контакт: контакты
сайт: сайтом
указатель: указатель
задавать: задаваемые
остерегаться: остерегайтесь
мошенничество: мошенничества
конфиденциальность: конфиденциальность
пользование: пользования
пожертвование: пожертвования