совбез: совбезе совбеза
оон: оон
обсудить: обсудили
вопрос: вопрос вопросы
кибератак: кибератак
медицинский: медицинские медицинским медицинских медицинского
учреждение: учреждения учреждение учреждений
требование: требованием
выкуп: выкупа выкуп
новость: новости
перейти: перейти
основное: основному
добро: добро
пожаловать: пожаловать
русский: русский
другой: другие
глобальный: глобальный
взгляд: взгляд
человеческий: человеческие
судьба: судьбы
поиск: поиск
расширить: расширенный
язык: язык
меню: меню
главный: главная
азия: азия
америка: америка
африка: африка
ближний: ближний
восток: восток
европа: европа
тема: темы теме
гуманитарный: гуманитарная
помощь: помощь помощью
беженец: беженцы
мигрант: мигранты
женщина: женщины
здравоохранение: здравоохранение здравоохранения
климат: климат
окружать: окружающая
среда: среда
культура: культура
образование: образование
международный: международное международным
правый: право права
мир: мир мира
безопасность: безопасность безопасности
генеральный: генеральный генерального
секретарить: секретарь секретаря
человек: человека
цель: цели
устойчивый: устойчивого
развитие: развития развитие
экономический: экономическое
подробный: подробнее
интервью: интервью
сюжет: сюжеты
экспресс-новости: экспресс-новости
фоторепортаж: фоторепортажи
пресс-секретарь: пресс-секретарь
выступление: выступления выступлении
заявление: заявления
пресса: прессой
официальный: официальные
поездка: поездки
фотография: фотографии
пресс-релиз: пресс-релизы
группа: группа группы
аккредитация: аккредитации
сми: сми
интернет-трансляция: интернет-трансляция
аудиотека: аудиотека
подписаться: подписаться
атака: атаки атаке атака атакам
хакеров-вымогателей: хакеров-вымогателей
становиться: становятся
частый: частым
явление: явлением
печать: печать
ноябрь: ноября
совет: совете совета
сегодня: сегодня
угроза: угрозу угроза угрозы
который: которую которой которая которых
представлять: представляют
себя: собой
это: это
относительно: относительно
новый: новая новым новой
форма: форма
преступный: преступной
деятельность: деятельности
хакер: хакер
лишать: лишает
доступ: доступа доступ
система: системе систему системы
дать: данных данные данным
ведомство: ведомства
оно: оно
согласиться: согласится согласились
заплатить: заплатить
выступать: выступая
глава: глава
воз: воз
предупредить: предупредил
подобный: подобные подобным
приводить: приводят
самый: самым
трагический: трагическим
последствие: последствиям
хакеры-вымогатели: хакеры-вымогатели
марта: марте
год: года году
больница: больница больницы больницах
университет: университета
город: городе
брно: брно
чехия: чехии
подвергнуться: подверглась подверглись подвергшихся
вымогательский: вымогательской
хакерский: хакерской
прийтись: пришлось
перевести: перевести
пациент: пациентов
соседний: соседние
отменить: отменить
плановый: плановые
процедура: процедуры
работа: работе работу
бумагоноситель: бумагоносителях
произойти: произошла
фон: фоне
чрезвычайный: чрезвычайного
положение: положения
связанный: связанного
пандемия: пандемией
пример: примеры
привести: привел привести
свое: своем своим
директор: директор
всемирный: всемирной
организация: организации
тедрос: тедрос
гебрейесус: гебрейесус
пятница: пятницу
также: также
рассказать: рассказал
министерство: министерство
ирландия: ирландии
начаться: началась
отправка: отправки
электронный: электронного
сообщение: сообщения
прикрепить: прикрепленным
файл: файлом файла
открытие: открытии
цифровой: цифровую цифровой
загрузить: загружена
вредоносный: вредоносная
программа: программа
распространиться: распространилась
всеять: всей
сеть: сети
минздрав: минздрава
зашифровать: зашифровала
примерный: примерно
процент: процентов
сделать: сделав
недоступный: недоступной
например: например
диагностический: диагностическую
платформа: платформу
пользоваться: пользовались пользоваться
сразу: сразу
несколько: несколько
объект: объектов объекты
результат: результате
многие: многим многие
крупный: крупным крупного
центр: центрам
страна: страны
отложить: отложить
жизненно: жизненно
важный: важные
жизнь: жизни жизнь
смерть: смерти
программы-вымогатели: программы-вымогатели
совершаться: совершаются
просто: просто
конфиденциальность: конфиденциальности конфиденциальность
отметить: отметил
хороший: лучшем
случай: случае
вести: ведет
сбой: сбоям
финансовый: финансовым финансовые
потеря: потерям потери
плохой: худшем
подрывать: подрывает
доверие: доверие
страдание: страданиям
гибель: гибели
вернуть: вернуть
иной: иного
баз: базе базам
злоумышленник: злоумышленники
требовать: требуют требовать
слово: словам
заниматься: занимающиеся
киберпреступностью: киберпреступностью
работать: работают
исходить: исходя
тот: той
логика: логики
мочь: могут
создать: создать
больший: больший
отказываться: отказываются
платить: платить
потенциально: потенциально
ставить: ставит
поэтому: поэтому
готовый: готовы
выплатить: выплатить
лишь: лишь
предоставлять: предоставляют
гарантия: гарантии
быть: будут
расшифровать: расшифрованы
повториться: повторится
добавить: добавил
опасный: опасная
тенденция: тенденция
число: число
такой: таких
кибернападений: кибернападений
расти: растет растут
треть: трети треть
участник: участников
исследование: исследования
провести: проведенного
сообщить: сообщили сообщив
меньший: меньшей
мера: мере
один: одной одна
значительный: значительная
часть: часть
респондент: респондентов
признать: признала
выплата: выплаты
получить: получили
убыток: убытки
сотня: сотни
миллион: миллионов
доллар: долларов
эдуардо: эдуардо
конрад: конрад
президент: президент
сша: сша
мая: мае
текущий: текущего
нападение: нападению нападениям
программы-вымогателя: программы-вымогателя
составить: составили
потратить: потратить
усилие: усилия усилиям
восстановление: восстановлению
масштаб: масштаб
кризис: кризиса
энна: энн
нойбергер: нойбергер
заместитель: заместитель
советник: советника
национальный: национальной
белый: белом
дом: доме
кибербезопасности: кибербезопасности
технология: технологиям
подчеркнуть: подчеркнула
инцидент: инцидентах
программами-вымогателями: программами-вымогателями
соединить: соединенных
штат: штатах
превысить: превысили
миллиард: миллиарда
эксперт: эксперты
область: области
связывать: связывают
увеличение: увеличением
смертность: смертности
сотрудничество: сотрудничество
выступить: выступившие
член: члены
призвать: призвали
противодействие: противодействию
однако: однако
постоянный: постоянный
представитель: представитель
россия: россии
василий: василий
небензя: небензя
поставить: поставил
сомнение: сомнение
необходимость: необходимость
вмешательство: вмешательства
подписываться: подписывайтесь
наш: нашу наши
рассылка: рассылку
загружать: загружайте
приложение: приложение
мобильный: мобильных
устройство: устройств
киберпреступность: киберпреступность
вено: вене
проходить: проходят
переговоры: переговоры
разработка: разработке
конвенция: конвенции конвенцией
борьба: борьбе
кибербезопасность: кибербезопасность
масштабный: масштабных
ответный: ответных
действие: действий
завершать: завершают
киберпреступности: киберпреступности
ресурс: ресурсы
информация: информация
партнер: партнеров
новостной: новостные
анонс: анонсы
журнал: журнал
отчет: отчеты
заседание: заседаниях
аудиовизуальный: аудиовизуальные
материал: материалы
общение: общение
твиттер: твиттер
последний: последние
главное: главные
брифинг: брифингов
стенограмма: стенограммы
комментарий: комментарии
журналист: журналистов
интернет: интернете
фейсбук: фейсбук
вконтакте: вконтакте
контакт: контакты
сайт: сайтом
указатель: указатель
часто: часто
задавать: задаваемые
остерегаться: остерегайтесь
мошенничество: мошенничества
условие: условия
пользование: пользования
пожертвование: пожертвования