интервью: интервью
ханс: ханс
клюге: клюге
работа: работы работу работа
сибирский: сибирской сибирских
тюрьма: тюрьме тюрьмах тюрьмы
пост: поста пост
глава: главы глава
воз: воз
европа: европе европа
новость: новости
оон: оон
перейти: перейти
основное: основному
добро: добро
пожаловать: пожаловать
русский: русский русского русском
другой: другие другому
глобальный: глобальный глобальным глобальной
взгляд: взгляд
человеческий: человеческие
судьба: судьбы
поиск: поиск
расширить: расширенный
язык: язык языка языке
меню: меню
главный: главная
азия: азия
америка: америка
африка: африка африке
ближний: ближний
восток: восток
тема: темы теме
гуманитарный: гуманитарная
помощь: помощь помощи
беженец: беженцы
мигрант: мигранты мигранта
женщина: женщины
здравоохранение: здравоохранение здравоохранения
климат: климат
окружать: окружающая
среда: среда
культура: культура
образование: образование
международный: международное
правый: право права прав
мир: мир мира миру
безопасность: безопасность
генеральный: генеральный генерального
секретарить: секретарь секретаря
человек: человека людей людьми люди людям
цель: цели
устойчивый: устойчивого
развитие: развития развитие
экономический: экономическое
подробный: подробнее
сюжет: сюжеты
экспресс-новости: экспресс-новости
фоторепортаж: фоторепортажи
пресс-секретарь: пресс-секретарь
выступление: выступления
заявление: заявления
пресса: прессой
официальный: официальные
поездка: поездки
фотография: фотографии
пресс-релиз: пресс-релизы
группа: группа
аккредитация: аккредитации
сми: сми
интернет-трансляция: интернет-трансляция
аудиотека: аудиотека
подписаться: подписаться
директор: директор директора
европейский: европейского европейское европейский европейском
региональный: регионального региональный региональные
бюро: бюро
центр: центре
время: время
визит: визита визиты
больница: больницу
днепропетровск: днепропетровске днепропетровск
украина: украина украиной
печать: печать
декабрь: декабря
бельгиец: бельгиец
возглавлять: возглавляет
всемирный: всемирной
организация: организации
охватывать: охватывающее
огромный: огромный
регион: регион региону региона регионах регионе
гренландия: гренландии
владивосток: владивостока
заместитель: заместителю
коммуникация: коммуникациям
мелисса: мелиссе
флеминг: флеминг
подкаста: подкаста
рассказать: рассказал
свое: своих своего своем
приоритет: приоритетах приоритеты приоритета
борьба: борьба
туберкулез: туберкулезом туберкулеза
сибирь: сибири
повлиять: повлияла
профессиональный: профессиональный
путь: путь пути
личной: личную
жизнь: жизнь жизни
любовь: любовь
картошка: картошка картошку
вырасти: выросший
католический: католических
традиция: традициях
изначально: изначально
думать: думал
миссионер: миссионера
хотеть: хотел хотят
помогать: помогать помогала
нуждаться: нуждающимся
разный: разных
уголок: уголках
однако: однако
оказаться: оказалось оказался оказались
прийтись: пришлось
отказаться: отказаться
романтический: романтических
отношение: отношений
это: это
молодой: молодого молодому
перебор: перебором
вместо: вместо
миссионерский: миссионерской
деятельность: деятельности
врач: врачи врач врачу
граница: границ
который: которая которой которого который которые
предоставить: предоставила
возможность: возможность возможностей
далекий: далеких
страна: странах стран страны
шанс: шанс
встретить: встретить
итог: итоге
произойти: произошло
качество: качестве
сотрудник: сотрудника
будущий: будущий
работать: работал работать
россия: россии россией
заниматься: занимался
лечение: лечением лечения
профилактика: профилактикой
влюбиться: влюбился
местный: местную
девушка: девушку
знать: знал
английский: английского
универсальный: универсальный
вспоминать: вспоминает
бабушка: бабушка
дедушка: дедушка
нынешний: нынешней
жена: жены
екатерина: екатерины екатериной
недавно: недавно
отметить: отметил
годовщина: годовщину
свадьба: свадьбы
поначалу: поначалу
принять: приняли
немецкий: немецкого
шпион: шпиона
студентка: студентка
томский: томского
университет: университета
лето: летом
жила: жила
родные: родных
деревня: деревне
расположить: расположенной
недалекий: недалеко
хозяйство: хозяйству
заслужить: заслужить
доверие: доверие доверия
пожилой: пожилых
вскопать: вскопать
результат: результат
оправдать: оправдал
усилие: усилия
окончание: окончания
контракт: контракта
рамка: рамках
решить: решил
остаться: остаться
ряд: рядом
устроиться: устроился
московский: московское
представительство: представительство
находить: находить
общий: общий
говорить: говорит говоря
показать: показала
важный: важно
учитывать: учитывать
культурный: культурные
особенность: особенности
адаптироваться: адаптироваться
условие: условиям условиях условия
также: также
слушать: слушать
самый: самых самый
сложный: сложных
обстоятельство: обстоятельствах
возюкочкин: возюкочкин
вопрос: вопросам вопросами вопрос вопросу вопросы
коронавирус: коронавируса
москва: москве
бок: бок
дать: дала
понимание: понимание
строить: строить
место: местах
впоследствии: впоследствии
несколько: несколько
год: лет года
мьянма: мьянме
привести: привел привело
кндр: кндр
многие: многие многим
задавать: задают задаваемые
каков: каково
северный: северной
корея: корее
отвечать: отвечаю
везде: везде
один: одного одним одной одно
ребенок: дети детей
здоровый: здоровы здоровый
иметь: имели
хороший: лучшее
будущее: будущее
делиться: делится
представитель: представитель
кризис: кризиса кризисами
уверить: уверен
именно: именно
опыт: опыт
получить: полученный получили
помочь: помог
справиться: справиться
вызов: вызовами
пандемия: пандемии пандемия
занять: занял
февраль: феврале
момент: момент момента
начало: начал
стремительно: стремительно
распространяться: распространяться
начинать: начинал
относительно: относительно
спокойный: спокойным
первое: первые первым
неделя: недели
измениться: изменилось
затем: затем
война: войны
включать: включая
конфликт: конфликт
стать: стали стал стало
часть: частью часть
наш: нашей нашему наш нашу наши
повестка: повестки
израиль: израилем израиль
газа: газой
затрагивать: затрагивает
принадлежать: принадлежит
газ: газа
усложнять: усложняет
объяснить: объяснил
позиция: позиции
подчеркнуть: подчеркнул
кандидат: кандидатом
свой: своей
кампания: кампании
побывать: побывал
часто: часто
участвовать: участвую
марафон: марафонах
длинный: длинный
забег: забег
мой: моей мое
видение: видение
заключаться: заключалось заключается
офис: офис
должен: должен должны
актуальный: актуален актуальна
каждый: каждой каждый
достаточно: достаточно
проблематичный: проблематично
ограничить: ограниченными ограничены
ресурс: ресурсами ресурсы
некоторые: некоторые
богатый: богатых богатые
разработать: разработать
политик: политику
соответствующий: соответствующую
интерес: интересам
довольный: довольно
сложно: сложно
четыре: четыре
предложить: предложенных
психический: психическое психического психических
здоровье: здоровье здоровья
иммунизация: иммунизация
поведенческий: поведенческие
исследование: исследования
цифровой: цифровое
доказать: доказали
важность: важность
сегодня: сегодня
проблема: проблема проблеме
пятый: пятый
мальчик: мальчик
пять: пяти
девочка: девочек
возраст: возрасте
чувствовать: чувствуют
одинокий: одинокими
больший: большую
временить: времени
постоянно: постоянно
одиночество: одиночество
невидимый: невидимый
убийца: убийца
отмечать: отмечает
стигматизация: стигматизация
расстройство: расстройств
оставаться: остается
препятствие: препятствием
получение: получения
изменение: изменения
возможный: возможны
привлечь: привлечь
внимание: внимание
общественность: общественности
простой: простые
шаг: шаги
такой: такие
домашние: домашние
сосед: соседям
мочь: могут
спасти: спасти
мнение: мнению
выявить: выявила
сильный: сильные
сторона: стороны
уязвимость: уязвимости
система: систем системы
ключевой: ключевых
урок: уроков
осознание: осознание
значимость: значимости
базовый: базовых
медицинский: медицинских
услуга: услуг услуги
скрининг: скрининг
рак: рака
приостановить: приостановлен
рост: росту рост
случай: случаев
заболевание: заболеваний
диагностик: диагностика
вич: вич
угроза: угрозой
уметь: уметь
одновременно: одновременно
справляться: справляться
поддерживать: поддерживать
регулярный: регулярную
особый: особое
уделять: уделяет
наука: науке
подчеркивать: подчеркивает
ложный: ложная
информация: информация
вакцинация: вакцинации
стоить: стоила
видимый: видим
число: числа
доза: дозы
вакцина: вакцины вакцин
называть: называемых
нулевой: нулевых
распространение: распространения
дезинформация: дезинформации
солидарность: солидарности
хранить: хранить
избыток: избыток
создавать: создавая
дефицит: дефицит
бедный: беднейших
сам: самое
главное: главное главные
обеспечение: обеспечение
неотложный: неотложное
лекарство: лекарство
сказать: сказал
кроме: кроме
мечта: мечта
означать: означает
зависимость: зависимости
финансовый: финансовых
сексуальный: сексуальной
ориентация: ориентации
статус: статуса
вести: вести
образ: образ
получать: получать
оно: оно
необходимо: необходимо
все: всем
подписываться: подписывайтесь
рассылка: рассылку
загружать: загружайте
приложение: приложение
мобильный: мобильных
устройство: устройств
появиться: появилась
уникальный: уникальная
взять: взять
контроль: контроль
достигнуть: достигла
переломный: переломного
август: августу
доминировать: доминировать
вариант: вариант
дельта: дельта
партнер: партнеров
новостной: новостные
анонс: анонсы
журнал: журнал
отчет: отчеты
заседание: заседаниях
аудиовизуальный: аудиовизуальные
материал: материалы
общение: общение
твиттер: твиттер
последний: последние
брифинг: брифингов
стенограмма: стенограммы
комментарий: комментарии
журналист: журналистов
интернет: интернете
фейсбук: фейсбук
вконтакте: вконтакте
контакт: контакты
пользоваться: пользоваться
сайт: сайтом
указатель: указатель
остерегаться: остерегайтесь
мошенничество: мошенничества
конфиденциальность: конфиденциальность
пользование: пользования
пожертвование: пожертвования