воз: воз
эскалация: эскалация эскалации
конфликт: конфликтов конфликт конфликта
природный: природные
бедствие: бедствия
приводить: приводят приводить приводя
рост: росту росте рост
потребность: потребностей
сфера: сфере
здравоохранение: здравоохранения здравоохранение
новость: новости
оон: оон
перейти: перейти
основное: основному
добро: добро
пожаловать: пожаловать пожалуй
русский: русский
другой: другие других
глобальный: глобальный
взгляд: взгляд
человеческий: человеческие
судьба: судьбы
поиск: поиск поисках
расширить: расширенный
язык: язык
меню: меню
главный: главная
азия: азия
америка: америка
африка: африка
ближний: ближний
восток: восток
европа: европа
тема: темы теме
гуманитарный: гуманитарная гуманитарной
помощь: помощь помощи
беженец: беженцы
мигрант: мигранты
женщина: женщины
климат: климат климата
окружать: окружающая окружающей
среда: среда среды
культура: культура
образование: образование
международный: международное международной
правый: право права
мир: мир мире
безопасность: безопасность безопасности
генеральный: генеральный генерального
секретарить: секретарь секретаря
человек: человека человек людей
цель: цели
устойчивый: устойчивого
развитие: развития развитие развитии
экономический: экономическое экономическим
подробный: подробнее
интервью: интервью
сюжет: сюжеты
экспресс-новости: экспресс-новости
фоторепортаж: фоторепортажи
пресс-секретарь: пресс-секретарь
выступление: выступления
заявление: заявления
пресса: прессой
официальный: официальные
поездка: поездки
фотография: фотографии
пресс-релиз: пресс-релизы
группа: группа
аккредитация: аккредитации
сми: сми
интернет-трансляция: интернет-трансляция
аудиотека: аудиотека
подписаться: подписаться
пациент: пациентов
газ: газы газе газа газу
эвакуировать: эвакуированы
оаэ: оаэ
печать: печать
август: августа
короткий: короткий
период: период
временить: времени
обнаружить: обнаружен
полиовирус: полиовирус
несколько: нескольких
страна: странах стран страны стране
произойти: произошла
военный: военных
угроза: угроз угрозами
северный: северном северного
дарфуре: дарфуре
судан: судане суданом судан
подтвердить: подтвержден
массовый: массовый массовому
голод: голод голоду
также: также
повсеместно: повсеместно
наблюдаться: наблюдалось
расти: растущее растет
воздействие: воздействие
изменение: изменения
частность: частности
волна: волн волны
жары: жары
наводнение: наводнений наводнения
сегодня: сегодня
предупредить: предупредила
глава: глава
региональный: регионального региональный региональная региональной
бюро: бюро
всемирный: всемирной
организация: организации организация
восточный: восточного восточный
средиземноморье: средиземноморья
ханан: ханан
балхи: балхи
призвать: призвала
воевать: воюющие
сторона: стороны
взять: взять
обязательство: обязательство
полный: полной
мера: мере
безоговорочно: безоговорочно
уважать: уважать
неприкосновенность: неприкосновенность
медицинский: медицинской медицинских
система: системы
мы: нам
нужный: нужен
безусловный: безусловный
неограниченный: неограниченный
доступ: доступ
все: всем всеми
нуждаться: нуждается нуждающихся нуждающимся
деятельность: деятельность
должен: должна
избавить: избавлена
политизация: политизации
нападки: нападок
заявить: заявила
представительница: представительница
кризис: кризис кризисом
сообщить: сообщила
последний: последнюю последние
неделя: неделю неделе
июль: июля
оказать: оказала
поддержка: поддержку поддержки
эвакуация: эвакуации
сопровождать: сопровождающих
бельгия: бельгию
испания: испанию
объединить: объединенные
арабский: арабские
эмират: эмираты
усилие: усилия
осложняться: осложняются
закрытие: закрытием
мая: мая
пограничный: пограничного пограничный
переход: перехода переход
рафа: рафах
течение: течение
месяц: месяцев
выступать: выступаем
открытие: открытие
возможный: возможных возможными возможное
маршрут: маршрутов
включать: включая
кпп: кпп
карем-шалом: карем-шалом
египет: египет
иордания: иорданию иордании
оттуда: оттуда
директор: директор
оставаться: остается
тысяча: тысяч тысячи
добавить: добавила
слово: словам
серьезный: серьезную серьезным
обеспокоенность: обеспокоенность
вызывать: вызывает
обнаружение: обнаружение
полиовируса: полиовируса
тип: типа
проба: пробах
сотрудничать: сотрудничает
министерство: министерством
анклав: анклава
детская: детским
фонд: фондом
юнисеф: юнисеф
ряд: ряду
вопрос: вопросов вопросы
проведение: проведение
кампания: кампаний
вакцинация: вакцинации
полиомиелит: полиомиелита
успешный: успешного
осуществление: осуществления
этот: этих
необходимо: необходимо
прекращение: прекращение
огонь: огня
подчеркнуть: подчеркнула
связь: связи
направлять: направляет
ливан: ливан
эксперт: экспертов
чрезвычайный: чрезвычайным чрезвычайных чрезвычайные
ситуация: ситуациям ситуациях ситуацию ситуации
материал: материалы
предоставить: предоставила
оборудование: оборудование
больница: больниц
мочь: могли могут
оказывать: оказывать
услуга: услуги
больший: большему
число: числу числе числа
пострадать: пострадавших пострадавшим
травма: травм
ранение: ранений ранения
работать: работает
сирия: сирии
иран: иране
регион: региона
создание: созданием
план: планов
действие: действий действие
отметить: отметила
надеяться: надеемся
прийтись: пришлось
насилие: насилие
недавний: недавнему
анализ: анализу
продолжаться: продолжающееся продолжаться
привести: привело привели
некоторые: некоторых
район: районах
дарфура: дарфура
лагер: лагере
замзам: замзам
замзаме: замзаме
проживать: проживают
менее: менее
внутренний: внутренне
переместить: перемещенных
лицо: лиц
срочный: срочно
обеспечить: обеспечить
путь: путями
граница: границы
прошлый: прошлой
смочь: смогла
доставить: доставить доставила
медикамент: медикаменты медикаментов
южный: южный
дарфур: дарфур
однако: однако
наиболее: наиболее
уязвимый: уязвимым
житель: жителям
открыть: открыть
чад: чадом
читать: читайте
прокурор: прокурор
муса: мус
виновный: виновные
зверство: зверствах
быть: будут
привлечь: привлечены
ответственность: ответственности
всеять: всей
продолжать: продолжает
вынуждать: вынуждать
бежать: бежать
война: война войны
крупный: крупнейшим
миллион: миллионов миллион
покинуть: покинули
свое: свои
дома: дома
осложнять: осложняют
проливной: проливные
дождь: дожди
который: которые
перемещение: перемещению
население: населения
нарушить: нарушили
доставка: доставку
систематический: систематическое
использование: использование
изнасилование: изнасилований
качество: качестве
орудие: орудия
являться: является
самый: самым
бесчеловечный: бесчеловечным
ужасать: ужасающим
аспект: аспектом
делать: делает
проводить: проводит проводят
обучение: обучение
работник: работников
метод: методам
клинический: клинического
ведение: ведения
случай: случаев
психосоциальной: психосоциальной
жертва: жертв жертвам
возможность: возможности
направление: направления
специалист: специалистам
климатический: климатические
катастрофа: катастрофы
экстремальный: экстремальные
погодный: погодные
явление: явления
шторм: штормы
потеря: потерям
происшествие: происшествия
иметь: имеют
масштабный: масштабные
последствие: последствия
распространение: распространению
болезный: болезней
передаваться: передающихся
вод: воду
инфекционный: инфекционных
заболевание: заболеваний
кроме: кроме
ухудшать: ухудшают
продовольствие: продовольствию
наносить: наносят
ущерб: ущерб
инфраструктура: инфраструктуре
нехватка: нехватке
специализированный: специализированной
недавно: недавно
результат: результате
сильный: сильного
афганистан: афганистане
погибнуть: погибли
получить: получили
оперативно: оперативно
метрический: метрических
тонна: тонн
машина: машины
скорый: скорой скорее скором
мобилизовать: мобилизовала
бригада: бригад
подписываться: подписывайтесь
наш: нашу наши
рассылка: рассылку
загружать: загружайте
приложение: приложение
мобильный: мобильных
устройство: устройств
борьба: борьбу борьбе
пандемия: пандемией
коронавирус: коронавируса
бедный: бедных
требоваться: требуется
миллиард: млрд
доллар: долларов
новый: новой новых
вспышка: вспышкой
холера: холеры
мешать: мешают
огромный: огромные
трудность: трудности
направить: направит
доза: доз
вакцина: вакцин
предупреждать: предупреждает предупреждают
заболеваемость: заболеваемости заболеваемость
вариант: вариантов варианты
дать: данным
олимпийский: олимпийских
игра: играх
париж: париже
заражение: заражения
вирус: вирусом
появиться: появиться
тяжелый: тяжелые
ресурс: ресурсы
информация: информация
партнер: партнеров
новостной: новостные
анонс: анонсы
журнал: журнал
отчет: отчеты
заседание: заседаниях
аудиовизуальный: аудиовизуальные
общение: общение
твиттер: твиттер
главное: главные
брифинг: брифингов
стенограмма: стенограммы
комментарий: комментарии
журналист: журналистов
интернет: интернете
фейсбук: фейсбук
вконтакте: вконтакте
контакт: контакты
пользоваться: пользоваться
сайт: сайтом
указатель: указатель
часто: часто
задавать: задаваемые
остерегаться: остерегайтесь
мошенничество: мошенничества
конфиденциальность: конфиденциальность
условие: условия
пользование: пользования
пожертвование: пожертвования