казахстан: казахстан казахстане казахстана
число: число числу числе
человек: людей человека человек люди
диабет: диабетом диабет диабета диабету
расти: растет расти
правительство: правительство
принимать: принимает
мера: меры мер мерой
новость: новости новостей
оон: оон
перейти: перейти
основное: основному основном
добро: добро
пожаловать: пожаловать
русский: русский
другой: другие других другими
глобальный: глобальный
взгляд: взгляд
человеческий: человеческие
судьба: судьбы
поиск: поиск
расширить: расширенный
язык: язык
меню: меню
главный: главная
азия: азия азии
америка: америка америки
африка: африка
ближний: ближний ближнего ближайшем
восток: восток востока
европа: европа
тема: темы теме
гуманитарный: гуманитарная
помощь: помощь помощи
беженец: беженцы
мигрант: мигранты
женщина: женщины
здравоохранение: здравоохранение здравоохранения здравоохранению
климат: климат
окружать: окружающая
среда: среда
культура: культура
образование: образование
международный: международное
правый: право права
мир: мир мира
безопасность: безопасность
генеральный: генеральный генерального
секретарить: секретарь секретаря
цель: цели
устойчивый: устойчивого
развитие: развития развитие
экономический: экономическое
подробный: подробнее
интервью: интервью
сюжет: сюжеты
экспресс-новости: экспресс-новости
фоторепортаж: фоторепортажи
пресс-секретарь: пресс-секретарь
выступление: выступления
заявление: заявления
пресса: прессой
официальный: официальные официальным
поездка: поездки
фотография: фотографии
пресс-релиз: пресс-релизы
группа: группа
аккредитация: аккредитации
сми: сми
интернет-трансляция: интернет-трансляция
аудиотека: аудиотека
подписаться: подписаться
камарго: камарго
вызвать: вызван
употребление: употреблением
напиток: напитков напитки
высокий: высоким выше высокая высокой
содержание: содержанием
сахар: сахара сахар
печать: печать
ноябрь: ноября
дать: данным данных
свыше: свыше
полумиллиона: полумиллиона
болеть: болеют
сахарный: сахарным сахарного
показатель: показатель показатели показателей
продолжать: продолжает
всемирный: всемирная всемирному всемирной
организация: организация организации
готовить: готовят готовит
ряд: ряд
остановить: остановить
тенденция: тенденцию тенденция
репортаж: репортаж
служба: службы службе
приурочить: приурочен
день: дню
борьба: борьбы борьбе
который: который которое
отмечать: отмечают
эпидемиологический: эпидемиологическая эпидемиологические
ситуация: ситуация
настоящее: настоящее
время: время
состоять: состоят
учет: учете
это: это
достаточно: достаточно
больший: большая
цифра: цифра
республика: республики
население: населением населения
миллион: миллионов
однако: однако
окончательный: окончательная
сообщить: сообщил сообщила
руководитель: руководитель
казахстанский: казахстанского казахстанские
общество: общества общество
изучение: изучению
кандидат: кандидат
медицинский: медицинских
наука: наук
жанай: жанай
аканов: аканов
эксперт: эксперты эксперт
считать: считают
следовать: следует
умножать: умножать
такой: таким такими такие таких
образ: образом
примерный: примерно
пять-шесть: пять-шесть
процент: процентов процента
казахстанец: казахстанцев казахстанцы
иметь: имеют имеет
проблема: проблемы
углеводный: углеводным
обмен: обменом
низкий: ниже
среднемировой: среднемировых
страна: странах стран странам
сша: сша
латинский: латинской
очень: очень
тучный: тучных
опасный: опасная
слово: словам словами
аканова: аканова
статистика: статистика
рост: росту роста
сегодня: сегодня
эндокринолог: эндокринологи эндокринологов
фиксировать: фиксируют
сто: ста
новый: новых нового
больной: больных
деть: день дело
темп: темпами
год: году год года годы
ожидать: ожидаем
диабетик: диабетиков
достигнуть: достигнет
тысяча: тысяч
добавить: добавил добавить
утверждать: утверждает
безусловный: безусловный
лидер: лидер
центральный: центральной
например: например
узбекистан: узбекистане
зарегистрировать: зарегистрированных
намного: намного
кыргызстан: кыргызстане
таджикистан: таджикистане
туркменистан: туркменистане
фото: фото
предоставить: предоставлено
жанаем: жанаем
акановым: акановым
несмотря: несмотря
относиться: относится
благополучный: благополучным
вопрос: вопросах вопросы
обеспечение: обеспечения
лекарственный: лекарственными
препарат: препаратами препаратов препарата
отметить: отметил
собеседник: собеседник
ежегодный: ежегодные ежегодного
расход: расходы
бюджет: бюджета
статья: статье
составлять: составляют
доллар: долларов
превышать: превышает
затрата: затраты
онкологический: онкологические
сердечно-сосудистый: сердечно-сосудистые
заболевание: заболевания заболеваниям заболевание
некоторые: некоторые
дорогой: дорогие
нуждаться: нуждающиеся
получать: получают
бесплатно: бесплатно
счет: счет
государство: государства
легкомысленный: легкомысленное
отношение: отношение отношения
свое: своему
здоровье: здоровью здоровье
мнение: мнению
ученый: ученого
заболеваемость: заболеваемость заболеваемости
несколько: нескольким несколько
причина: причинам причины причин
пренебрежительный: пренебрежительного
частить: части
сожаление: сожалению
многие: многие многих
выявление: выявлении
проявлять: проявляют
халатность: халатность
легкомыслие: легкомыслие
ход: ходе
лечение: лечения лечению
добиваться: добиваются
нормальный: нормального
уровень: уровня уровнем уровне
жить: живут
кровь: крови
поначалу: поначалу
этот: эта
категория: категория
пациент: пациентов пациента
ссылаться: ссылается
нехватка: нехватку
временить: времени
объяснять: объясняя
большой: большой большого
занятость: занятостью
работа: работе работу
семья: семье
рекомендация: рекомендации
врач: врачей врачи
важный: важно
придерживаться: придерживаться
диета: диеты
заниматься: заниматься
спорт: спортом
гулять: гулять
регулярно: регулярно
проходить: проходить
скрининг: скрининг
игнорироваться: игнорируются
ухудшение: ухудшении
состояние: состояния состояние
попадать: попадают
сразу: сразу
операционный: операционный
стол: стол
либо: либо
инфаркт: инфарктом
инсульт: инсультом
гангрена: гангреной
нижний: нижних нижней
конечность: конечностей конечности
готовый: готовы
отдать: отдать
угодно: угодно
спасти: спасти
поздно: поздно
все: всем всему
обвинять: обвиняют
пример: примеру
пятилетняя: пятилетняя
выживаемость: выживаемость
ампутация: ампутации ампутаций
продолжить: продолжил
осложнение: осложнений
средний: среднем
пять: пять
лишаться: лишаются
достигать: достигает
сравнение: сравнения
япония: японии
ежегодно: ежегодно
проводиться: проводится
лишь: лишь
операция: операций
теория: теорий
эволюция: эволюции
сказать: сказал сказала
мой: моим
исследование: исследованиям
один: одна
главное: главных главные
питание: питание питания
вернее: вернее
качество: качество
употреблять: употребляемых употребляло
пища: пищу
продукт: продуктов продукты
человечество: человечество
натуральный: натуральные
редко: редко
консервы: консервы
сторона: стороны сторонами
передаваться: передается передавалась
генетически: генетически
плохо: плохо
поддаваться: поддавался
смертность: смертность
умирать: умирали
рано: рано
генетический: генетическая генетическим
информация: информация
далекий: дальше
следующий: следующим
поколение: поколениям
создание: созданием
инсулин: инсулина инсулин
очистки: очистки
прорывной: прорывных
также: также
появление: появлением
количество: количества количество
консервированный: консервированных
гликемическим: гликемическим
индекс: индексом
набор: набором
резкий: резко
пошло: пошло
вверх: вверх
всплеск: всплеск
прийтись: пришелся
прошлый: прошлого
столетие: столетия
сей: сих
пора: пор
снижаться: снижается
иной: иными
вина: виной
генетик: генетика
комфорт: комфорт
вредный: вредные
объяснение: объяснение
заключить: заключил
касаться: касается
хотеть: хочу
слабый: слабую слабый
профилактический: профилактическую
контроль: контроль
первичный: первичной
медико-санитарный: медико-санитарной
воз: воз
национальный: национальный
координатор: координатор
программа: программ программу
общественный: общественному
представительство: представительства
лаура: лаура
утемисова: утемисова
диабетический: диабетическая диабетическую
настороженность: настороженность
назад: назад
принять: принят примет
клинический: клинический
протокол: протокол
преддиабет: преддиабет
успешный: успешно
применяться: применяется
медик: медиками
первый: первую
очередь: очередь
ставиться: ставится
задача: задача
сформировать: сформировать
называть: называемую
патологический: патологическое
требовать: требует
своевременный: своевременного
вмешательство: вмешательства
медиков: медиков
стоматолог: стоматолог
видеть: видит
выпадать: выпадают
зуб: зубы
десна: десен
должен: должен должны должно
обязательно: обязательно
отправить: отправить
анализ: анализы
аналогичный: аналогично
вести: вести
гинеколог: гинекологи
уролог: урологи
целый: целом
наготове: наготове
помнить: помня
компенсировать: компенсировать
доводить: доводя
убежденный: убежден
позволить: позволит
добиться: добиться
снижение: снижения
использовать: используя
превентивный: превентивные
производить: производят
миллиард: миллиарда
литровый: литров
сахаросодержащий: сахаросодержащих сахаросодержащие
предлагать: предлагает
ввести: ввести
налог: налог налога
продукция: продукцию
сделать: сделали
совместно: совместно
министерство: министерством
заинтересовать: заинтересованными
введение: введению введения
шаг: шаг
эффективный: эффективной
избыточный: избыточным
потребление: потреблением
надеяться: надеемся
будущее: будущем
положительный: положительное
решение: решение
касательно: касательно
налоговый: налогов
самый: самым
доступность: доступность
снизить: снижена
подписываться: подписывайтесь
наш: нашу наши
рассылка: рассылку
загружать: загружайте
приложение: приложение
мобильный: мобильных
устройство: устройств
подросток: подростки
предупреждать: предупреждает
фальсификация: фальсификации
оземпик: оземпик
вскоре: вскоре
рынок: рынке
появиться: появиться
доступный: доступный
цена: цене
ресурс: ресурсы
партнер: партнеров
новостной: новостные
анонс: анонсы
журнал: журнал
отчет: отчеты
заседание: заседаниях
аудиовизуальный: аудиовизуальные
материал: материалы
общение: общение
твиттер: твиттер
последний: последние
брифинг: брифингов
стенограмма: стенограммы
комментарий: комментарии
журналист: журналистов
интернет: интернете
фейсбук: фейсбук
вконтакте: вконтакте
контакт: контакты
пользоваться: пользоваться
сайт: сайтом
указатель: указатель
часто: часто
задавать: задаваемые
остерегаться: остерегайтесь
мошенничество: мошенничества
конфиденциальность: конфиденциальность
условие: условия
пользование: пользования
пожертвование: пожертвования