европейский: европейском европейского европейский
регион: регионе регион
зарегистрировать: зарегистрировано зарегистрированных
сам: самое
большой: большое наибольшее
число: число
случай: случаев
заболевание: заболевания
корь: корью кори корь
последний: последние
год: лет году годом года годах
новость: новости
оон: оон
перейти: перейти
основное: основному
добро: добро
пожаловать: пожаловать
русский: русский
другой: другие
глобальный: глобальный
взгляд: взгляд
человеческий: человеческие
судьба: судьбы
поиск: поиск
расширить: расширенный
язык: язык
меню: меню
главный: главная
азия: азия азии
америка: америка
африка: африка
ближний: ближний
восток: восток
европа: европа европы европе
тема: темы теме
гуманитарный: гуманитарная
помощь: помощь
беженец: беженцы
мигрант: мигранты
женщина: женщины
здравоохранение: здравоохранение здравоохранения
климат: климат
окружать: окружающая
среда: среда
культура: культура
образование: образование
международный: международное
правый: право права
мир: мир мире
безопасность: безопасность безопасности
генеральный: генеральный генерального
секретарить: секретарь секретаря
человек: человека людей
цель: цели
устойчивый: устойчивого устойчивые
развитие: развития развитие
экономический: экономическое
подробный: подробнее
интервью: интервью
сюжет: сюжеты
экспресс-новости: экспресс-новости
фоторепортаж: фоторепортажи
пресс-секретарь: пресс-секретарь
выступление: выступления
заявление: заявления
пресса: прессой
официальный: официальные
поездка: поездки
фотография: фотографии
пресс-релиз: пресс-релизы
группа: группа
аккредитация: аккредитации
сми: сми
интернет-трансляция: интернет-трансляция
аудиотека: аудиотека
подписаться: подписаться
воз: воз
вакцинация: вакцинация вакцинации вакцинацией
являться: является
хороший: лучшей
защита: защитой
печать: печать
марта: марта
анализ: анализу
провести: проведенному
всемирный: всемирной
организация: организацией
юнисеф: юнисеф
вдвое: вдвое
ранее: ранее
самый: самым самых
высокий: высоким высокого
показатель: показателем показатель показателям
процент: процентов
страна: странах стране стран
центральный: центральной
приходиться: приходится приходилась
ребенок: детей
возраст: возрасте
пять: пяти
половина: половины
потребовать: потребовали
госпитализация: госпитализации
предварительный: предварительным
дать: данным
получить: полученным получили
состояние: состоянию
зафиксировать: зафиксировано
фатальный: фатальных
исход: исходов
тысяча: тысяч
заболеваемость: заболеваемость заболеваемости
целый: целом
снижаться: снижается
достигнуть: достиг
минимум: минимума
затем: затем
произойти: произошел
всплеск: всплеск
снижение: снижения
охват: охвата охвату охвате
иммунизация: иммунизацией иммунизации
время: время
пандемия: пандемии
вновь: вновь
значительно: значительно
возрасти: возросло
уровень: уровень
многие: многих
вернуться: вернулся вернулась
допандемийным: допандемийным
повышать: повышает
риск: риск
вспышка: вспышек
это: это
тревожный: тревожный
звонкий: звонок
предупредить: предупредил
ханс: ханс
клюге: клюге
директор: директор
региональный: регионального региональный
бюро: бюро
должен: должны
позволить: позволить
сдавать: сдавать
позиция: позиции
каждый: каждой
нужно: нужно
активизировать: активизировать
усилие: усилия
недостаточно: недостаточно
вакцинировать: вакцинированных
сообщество: сообществ
вирус: вирус вирусов вируса
успокаиваться: успокаивается
треть: треть
полмиллиона: полмиллиона
первый: первую
доза: дозу
вакцина: вакцины вакцин
рамка: рамках
плановый: плановой
румыния: румынии
следовать: следует
казахстан: казахстан
пробел: пробелы
резкий: резко
указывать: указывает
сказать: сказала
регина: регина
доминикис: доминикис
защитить: защитить
опасный: опасной
болезнь: болезни
необходимо: необходимо
принять: принять
срочный: срочные
мера: меры
включать: включая
инвестиция: инвестиции
сфера: сферу
заразный: заразных
поражающий: поражающих
помимо: помимо
смерть: смерти
вызвать: вызванных
осложнение: осложнениями осложнения
пневмония: пневмонию
энцефалит: энцефалит
диарея: диарею
обезвоживание: обезвоживание
вызывать: вызывать
долгосрочный: долгосрочные
такой: такие
слепота: слепота
также: также
нарушить: нарушить
работа: работу
иммунный: иммунной
система: системы
стирать: стирая
память: память
бороться: бороться
инфекция: инфекциями
подписываться: подписывайтесь
наш: нашу наши
рассылка: рассылку
загружать: загружайте
приложение: приложение
мобильный: мобильных
устройство: устройств
проигрывать: проигрывает
битва: битву
украина: украину
женева: женеве
обсуждать: обсуждают
вопрос: вопросы
ресурс: ресурсы
информация: информация
партнер: партнеров
новостной: новостные
анонс: анонсы
журнал: журнал
отчет: отчеты
заседание: заседаниях
аудиовизуальный: аудиовизуальные
материал: материалы
общение: общение
твиттер: твиттер
главное: главные
брифинг: брифингов
стенограмма: стенограммы
комментарий: комментарии
журналист: журналистов
интернет: интернете
фейсбук: фейсбук
вконтакте: вконтакте
контакт: контакты
пользоваться: пользоваться
сайт: сайтом
указатель: указатель
часто: часто
задавать: задаваемые
остерегаться: остерегайтесь
мошенничество: мошенничества
конфиденциальность: конфиденциальность
условие: условия
пользование: пользования
пожертвование: пожертвования