воз: воз
рекомендовать: рекомендует
увеличить: увеличить
инвестиция: инвестиции инвестиций
вакцина: вакцины вакцин вакцинам вакцинах
снизить: снизить
смертность: смертность смертности
устойчивость: устойчивости устойчивость устойчивостью
антибиотик: антибиотикам антибиотиков
новость: новости
оон: оон
перейти: перейти
основное: основному
добро: добро
пожаловать: пожаловать
русский: русский
другой: другие
глобальный: глобальный глобальных
взгляд: взгляд
человеческий: человеческие
судьба: судьбы
поиск: поиск
расширить: расширенный
язык: язык
меню: меню
главный: главная
азия: азия
америка: америка
африка: африка
ближний: ближний
восток: восток
европа: европа
тема: темы теме
гуманитарный: гуманитарная
помощь: помощь
беженец: беженцы
мигрант: мигранты
женщина: женщины
здравоохранение: здравоохранение здравоохранения здравоохранению
климат: климат
окружать: окружающая
среда: среда
культура: культура
образование: образование
международный: международное
правый: право права
мир: мир мире
безопасность: безопасность
генеральный: генеральный генеральной генерального
секретарить: секретарь секретаря
человек: человека
цель: цели
устойчивый: устойчивого устойчивых
развитие: развития развитие
экономический: экономическое экономические
подробный: подробнее
интервью: интервью
сюжет: сюжеты
экспресс-новости: экспресс-новости
фоторепортаж: фоторепортажи
пресс-секретарь: пресс-секретарь
выступление: выступления
заявление: заявления
пресса: прессой
официальный: официальные
поездка: поездки
фотография: фотографии
пресс-релиз: пресс-релизы
группа: группа
аккредитация: аккредитации
сми: сми
интернет-трансляция: интернет-трансляция
аудиотека: аудиотека
подписаться: подписаться
возс: возс
пабст: пабст
противомикробный: противомикробным противомикробных
препарат: препаратам препаратов
ставить: ставит
угроза: угрозу угроз
достигнутый: достигнутый
последний: последнее последние
столетие: столетие
прогресс: прогресс
область: области
медицина: медицины
печать: печать
октябрь: октября
увеличение: увеличение
уменьшить: уменьшить
показатель: показатели показателей
вызвать: вызванной
упп: упп
сократить: сократить
использование: использование
миллиард: миллиарда миллиардов
доза: доз
год: год году
говориться: говорится
опубликовать: опубликованном опубликованного
четверг: четверг
доклад: докладе доклад
всемирный: всемирной
организация: организации
возникать: возникает
бактерия: бактерии
вирус: вирусы
грибок: грибки
паразит: паразиты
время: временем
мутировать: мутируют
переставать: перестают
реагировать: реагировать
лечение: лечение лечения лечению
входить: входит
число: число
основной: основных основными
общественный: общественному
вызывать: вызывая
ежегодно: ежегодно
пять: пять
миллион: миллионов
смерть: смертей
фактор: фактором
являться: является
неправильный: неправильное
чрезмерный: чрезмерное
разработка: разработка
новый: новых
важный: важная
часть: часть
усилие: усилий
борьба: борьбе борьба
предотвращать: предотвращают
распространение: распространение
инфекция: инфекций
сокращать: сокращают
замедлять: замедляют
появление: появление
лекарство: лекарствам
патоген: патогенов
сила: сила
начинаться: начинается
профилактика: профилактики профилактика
самый: самых
мощный: мощных
инструмент: инструментов
достижение: достижения
заявить: заявил
директор: директор
тедрос: тедрос
адханом: адханом
гебрейесус: гебрейесус
отмечаться: отмечается
мочь: могут
количество: количество
использовать: используемых используемые
вид: видов
процент: процента процентов
ежедневный: ежедневных
все: всем
некоторые: некоторые
этот: этих
доступный: доступны
использоваться: используются
недостаточный: недостаточных
масштаб: масштабах
предстоять: предстоит
разработать: разработать
скорый: скорее
вывести: вывести
рынок: рынок
предотвращение: предотвращение
расширение: расширение
доступ: доступа
продолжение: продолжением
исследование: исследования исследований
прошлый: прошлом
оценка: оценкам
пневмония: пневмонии
менингит: менингита
брюшной: брюшного
тиф: тифа
предотвратить: предотвратить
тысяча: тысяч
связанный: связанных связанной
каждый: каждый
существовать: существующим
критический: критических
заболевание: заболеваний
такой: таких
туберкулез: туберкулез
иметь: имеют
решающий: решающее
значение: значение
спасение: спасения
жизнь: жизней
перелом: перелома
ситуация: ситуации
сказать: сказал
глава: глава
декларация: декларация декларацию декларации
действие: действиях действий
значительно: значительно
существенный: существенные
издержка: издержки
расход: расходы расходов
больница: больниц
оцениваться: оцениваются
доллар: долларов
прогноз: прогнозам
сэкономить: сэкономить
минимум: минимум
треть: треть
ход: ходе
неделя: недели
высокий: высокого
уровень: уровня
ассамблея: ассамблеи
сентябрь: сентябре
мировой: мировые
лидер: лидеры
принять: приняли
политический: политическую
который: которой
взять: взяли
обязательство: обязательство
установить: установить
четкий: четкий
набор: набор
целый: целей
включать: включая
сокращение: сокращение
ежегодный: ежегодных
бактериальный: бактериальной
подчеркиваться: подчеркивается
важность: важность
широкий: широкого
лекарственный: лекарственным
средство: средствам
диагностик: диагностике
также: также
необходимость: необходимость
создание: создания
механизм: механизмов
финансирование: финансирования
поддержка: поддержки
научный: научных
инновация: инноваций
подписываться: подписывайтесь
наш: нашу наши
рассылка: рассылку
загружать: загружайте
приложение: приложение
мобильный: мобильных
устройство: устройств
фейсбук: фейсбук
инстаграм: инстаграм
помочь: помогут
распространять: распространять
достоверный: достоверную
информация: информацию информация
ученый: ученые
начать: начали
испытание: испытание
коронавирус: коронавируса
снова: снова
расти: растет
ресурс: ресурсы
партнер: партнеров
новостной: новостные
анонс: анонсы
журнал: журнал
отчет: отчеты
заседание: заседаниях
аудиовизуальный: аудиовизуальные
материал: материалы
общение: общение
твиттер: твиттер
главное: главные
брифинг: брифингов
стенограмма: стенограммы
комментарий: комментарии
журналист: журналистов
интернет: интернете
вконтакте: вконтакте
контакт: контакты
пользоваться: пользоваться
сайт: сайтом
указатель: указатель
часто: часто
задавать: задаваемые
вопрос: вопросы
остерегаться: остерегайтесь
мошенничество: мошенничества
конфиденциальность: конфиденциальность
условие: условия
пользование: пользования
пожертвование: пожертвования