июль: июль июлем июля июле
год: года год лет году
мочь: мог могут
самый: самым самых
жаркий: жарким жарко жарких жаркими жаркому жаркая
месяц: месяцем месяц месяцев месяца
история: историю истории
наблюденье: наблюдений
новость: новости
оон: оон
перейти: перейти
основное: основному
добро: добро
пожаловать: пожаловать
русский: русский
другой: другие других
глобальный: глобальный
взгляд: взгляд
человеческий: человеческие человеческим
судьба: судьбы
поиск: поиск
расширить: расширенный
язык: язык
меню: меню
главный: главная
азия: азия
америка: америка америке
африка: африка африке
ближний: ближний
восток: восток
европа: европа
тема: темы теме
гуманитарный: гуманитарная
помощь: помощь
беженец: беженцы
мигрант: мигранты
женщина: женщины женщин
здравоохранение: здравоохранение здравоохранения
климат: климат климата климату
окружать: окружающая
среда: среда
культура: культура
образование: образование
международный: международное
правый: право права
мир: мир миру
безопасность: безопасность
генеральный: генеральный генерального
секретарить: секретарь секретаря
человек: человека людей человек
цель: цели
устойчивый: устойчивого
развитие: развития развитие
экономический: экономическое
подробный: подробнее
интервью: интервью
сюжет: сюжеты
экспресс-новости: экспресс-новости
фоторепортаж: фоторепортажи
пресс-секретарь: пресс-секретарь
выступление: выступления
заявление: заявления
пресса: прессой
официальный: официальные
поездка: поездки
фотография: фотографии
пресс-релиз: пресс-релизы
группа: группа
аккредитация: аккредитации
сми: сми
интернет-трансляция: интернет-трансляция
аудиотека: аудиотека
подписаться: подписаться
фджонс: фджонс
сотня: сотни
миллион: миллионов миллиона
оказаться: оказались оказавшихся
власть: власти
экстремальный: экстремальной экстремальная
жары: жары
печать: печать
август: августа
отни: отни
все: всему
подвергнуться: подверглись
это: этим
лето: летом лету
воздействие: воздействию воздействием
скорый: скорее
сообщать: сообщают
всемирный: всемирной
метеорологический: метеорологической
организация: организации организацией
ссылаться: ссылаясь
дать: данные данным
национальный: национального
управление: управления
океанический: океанических
атмосферный: атмосферных
исследование: исследований исследовании
сша: сша
кроме: кроме
минувший: минувший
средний: средняя среднего средний среднем
температура: температура температуры температурой температурах
градус: градуса градусов
цельсий: цельсия цельсию
превысить: превысила
показатель: показатель показателя
продолжительный: продолжительная продолжительные
сильный: сильная
жар: жара жаре
подчеркивать: подчеркивает
необходимость: необходимость
срочный: срочных
действие: действий действию
борьба: борьбе
изменение: изменением изменения изменение
адаптация: адаптации
последствие: последствиям
который: которым которые
неоднократно: неоднократно
призывать: призывал
широкий: широко
распространить: распространенные
интенсивный: интенсивные
волна: волны волнах волна волн
теплый: тепла теплом теплых
прошедший: прошедший
обрушиться: обрушились
каждый: каждый
континент: континент
меньший: меньшей
мера: мере меры
десять: десяти
страна: странах стран страны
зарегистрировать: зарегистрированы зарегистрирована зарегистрировала
ежедневный: ежедневные
один: одном одной
место: месте
становиться: становится
слишком: слишком
трудный: трудно
справляться: справляться
сказать: сказала
вмо: вмо
селеста: селеста
сауло: сауло
долина: долине
смерть: смерти
калифорний: калифорнии
рекордный: рекордная рекордных
среднемесячный: среднемесячная
возможно: возможно
новый: новый новому
мировой: мировой
рекорд: рекорд рекордов
отдаленный: отдаленные
ледяной: ледяные
щит: щиты
антарктида: антарктиды
добавить: добавила
стремиться: стремится
отреагировать: отреагировать
призыв: призыв
число: числе число
улучшить: улучшив
система: системы
ранний: раннего
предупреждение: предупреждения
последний: последние
оценка: оценки
представить: представленные
показывать: показывают
подобный: подобные
спасти: спасти
тысяча: тысяч
жизнь: жизней жизни
лишь: лишь
недостаточно: недостаточно
мы: нам
нужно: нужно
устранить: устранить
первопричина: первопричину
серьезный: серьезно
заняться: заняться
сокращение: сокращением
уровень: уровней уровень
выброс: выбросов
парниковый: парниковых
газ: газов
отметить: отметила
многие: многих
район: районах
средиземноморье: средиземноморья средиземноморье
балкан: балкан
наблюдаться: наблюдались наблюдалась наблюдается
привести: привело
жертва: жертвам
отрицательно: отрицательно
сказаться: сказалось
здоровье: здоровье здоровья
население: населения
целый: целом
провести: проведенном
ученый: учеными
говориться: говорится
греция: греции грецию
италия: италии
испания: испании испания
португалия: португалии
франция: франции
марокко: марокко
произойти: произошли произошло
вызвать: вызванного вызванный
деятельность: деятельностью
несколько: несколько
включать: включая
венгрия: венгрию
словения: словению
хорватия: хорватию
болгария: болгарию
сообщить: сообщили
сам: самом
четыре: четыре четырех
зафиксировать: зафиксированы
июльский: июльских
минимум: минимум
обсерватория: обсерватория
фабра: фабра
барселона: барселоне
максимальный: максимальной
исключительно: исключительно
конец: конце
первый: первая
повлиять: повлияло
самочувствие: самочувствие
спортсмен: спортсменов
зритель: зрителей
олимпийский: олимпийских
игра: играх
париж: париже
северный: северная
первое: первого
соединить: соединенных
штат: штатах
половина: половина
получить: получили
день: дней дня дни
установить: установлено установил
температурный: температурных
лас-вегас: лас-вегас
подряд: подряд
высокий: выше высоких
предыдущий: предыдущий
составлять: составлял составляет
второе: второго
крупный: крупных
лесной: лесных
пожар: пожара пожары пожаров
начало: начала
сжечь: сожгли
гектар: гектаров
лес: леса
значительно: значительно
площадь: площади
выгореть: выгоревшей
территория: территории
период: период
состояние: состоянию
третье: третье
канада: канаде
бушевать: бушевало
выйти: вышли
контроль: контроля
канадский: канадского
межведомственный: межведомственного
центр: центра
особенно: особенно
пострадать: пострадали
британский: британская британской
колумбия: колумбия колумбии
альберт: альберта
сгореть: сгорело
вдвое: вдвое
превышать: превышает
влияние: влияние
ребенок: детей дети
анализ: анализу
детский: детского
фонд: фонда
юнисеф: юнисеф
полмиллиарда: полмиллиарда
жить: живет живут
экстремально: экстремально
назад: назад
считаться: считаются
такой: таких такими таким
жесткий: жестких
климатический: климатических
условие: условиях условия
доступ: доступа
инфраструктура: инфраструктуре
услуга: услугам
помочь: помогли
легко: легко
справиться: справиться
жара: жарой
усиливаться: усиливается
негативный: негативно
сказываться: сказываясь
благополучие: благополучии благополучия
повседневный: повседневной
исполнительный: исполнительный
директор: директор
кэтрин: кэтрин
рассел: рассел
западный: западной
центральный: центральной
чаща: чаще
сталкиваться: сталкиваются
треть: трети
мали: мали
достигать: достигает
нигер: нигере
сенегал: сенегале
судан: судане
латинский: латинской
карибский: карибском
бассейн: бассейне
раз: раза
чрезвычайный: чрезвычайно
подвергаться: подвергаются
теплов: тепловой
стресс: стресс стресса
представлять: представляет
особый: особую
угроза: угрозу
беременная: беременных
возможность: возможности
охлаждать: охлаждать
организм: организм
вести: вести ведет
осложнение: осложнениям
беременность: беременности беременность
гестационные: гестационные
хронический: хронические
заболевание: заболевания заболеваниям
неблагоприятный: неблагоприятным
исход: исходам
роды: родов роды
мертворождение: мертворождение
низкий: низкий
вес: вес
рождение: рождении
преждевременный: преждевременные
избыточный: избыточный
тепловой: теплового
также: также
недоедание: недоеданию
неинфекционный: неинфекционным
делать: делает
уязвимый: уязвимыми
инфекционный: инфекционным
болезнь: болезням
распространяться: распространяются
малярия: малярия
лихорадка: лихорадка
денге: денге
подписываться: подписывайтесь
наш: нашу наши
рассылка: рассылку
загружать: загружайте
приложение: приложение
мобильный: мобильных
устройство: устройств
воз: воз
подготовиться: подготовиться
сухой: сухому
европейский: европейском
регион: регионе
совет: советы
спастись: спастись
летний: летней
пандемия: пандемии
погода: погода
влиять: влияет
два: две
будущее: будущие
мама: мамы
задавать: задают задаваемые
вопрос: вопросы
акушерка: акушерке
ресурс: ресурсы
информация: информация
партнер: партнеров
новостной: новостные
анонс: анонсы
журнал: журнал
отчет: отчеты
заседание: заседаниях
аудиовизуальный: аудиовизуальные
материал: материалы
общение: общение
твиттер: твиттер
главное: главные
брифинг: брифингов
стенограмма: стенограммы
комментарий: комментарии
журналист: журналистов
интернет: интернете
фейсбук: фейсбук
вконтакте: вконтакте
контакт: контакты
пользоваться: пользоваться
сайт: сайтом
указатель: указатель
часто: часто
остерегаться: остерегайтесь
мошенничество: мошенничества
конфиденциальность: конфиденциальность
пользование: пользования
пожертвование: пожертвования