интервью: интервью
интернациональный: интернациональная
команда: команда команде
расширять: расширяет
возможность: возможности возможностей возможность возможностью
сельский: сельских
житель: жителей жители
никарагуа: никарагуа
гватемала: гватемале гватемалы гватемала
новость: новости новостей
оон: оон
перейти: перейти
основное: основному
добро: добро
пожаловать: пожаловать
русский: русский
другой: другие другими других
глобальный: глобальный глобальные глобальная глобального глобальных
взгляд: взгляд
человеческий: человеческие человеческая человеческих
судьба: судьбы
поиск: поиск поиска
расширить: расширенный
язык: язык языке
меню: меню
главный: главная
азия: азия
америка: америка америки
африка: африка
ближний: ближний
восток: восток
европа: европа
тема: темы теме
гуманитарный: гуманитарная гуманитарной
помощь: помощь помощи
беженец: беженцы
мигрант: мигранты
женщина: женщины женщин
здравоохранение: здравоохранение здравоохранения
климат: климат климата
окружать: окружающая
среда: среда
культура: культура
образование: образование образованию
международный: международное международной международному
правый: право права
мир: мир миру мира
безопасность: безопасность
генеральный: генеральный генеральная генерального
секретарить: секретарь секретаря
человек: человека людей людям человек люди
цель: цели целях
устойчивый: устойчивого
развитие: развития развитие
экономический: экономическое экономических экономическом
подробный: подробнее
сюжет: сюжеты
экспресс-новости: экспресс-новости
фоторепортаж: фоторепортажи
пресс-секретарь: пресс-секретарь
выступление: выступления
заявление: заявления
пресса: прессой
официальный: официальные
поездка: поездки
фотография: фотографии
пресс-релиз: пресс-релизы
группа: группа групп
аккредитация: аккредитации
сми: сми
интернет-трансляция: интернет-трансляция
аудиотека: аудиотека
подписаться: подписаться
фото: фото
предоставить: предоставлено предоставила
естуконог: естуконог
викторий: виктория
валиков: валикова
сооснователь: сооснователь
директор: директор
клиника: клинике клиники клиник клиника
печать: печать
сентябрь: сентября сентябре
штаб-квартира: штаб-квартиру
нью-йорк: нью-йорке
приезжать: приезжают
лидер: лидеры
государство: государств государствах
высокопоставленный: высокопоставленные
чиновник: чиновники
представитель: представители представителями
множество: множества
некоммерческий: некоммерческих
организация: организаций организации организация организациями
нко: нко
который: которые которым которое которая
работать: работают работаем
все: всему
поддерживать: поддерживая поддерживает
область: области
год: году
екатерина: екатерина
стуконог: стуконог
корнеев: корнеева
этот: эта этих
построить: построила построить
два: две
помочь: помогла помочь помогло
десятка: десяткам
тысяча: тысяч
доброволец: добровольцы
сотрудник: сотрудники
консультировать: консультируют
пациент: пациентов пациентами
обеспечивать: обеспечивают
жизненно: жизненно
необходимый: необходимыми
медикамент: медикаментами медикаментам
число: числе число
хронический: хроническими
заболевание: заболеваниями заболеваний
представительница: представительницы
рассказать: рассказали расскажите рассказать
евгения: евгении
клещевой: клещевой
служба: службы служба
свой: своей
миссия: миссии миссия
мероприятие: мероприятия мероприятии мероприятиях
сотрудничество: сотрудничество
мочь: могут могу можем
обеспечить: обеспечить
медицинский: медицинскую медицинской медицинскому медицинских медицинским медицинские медицинская
труднодоступный: труднодоступных труднодоступной труднодоступном
район: районах
заключаться: заключается
доступ: доступ доступа
базовый: базовой базовую базовый
это: это
крайне: крайне
сложно: сложно
независимо: независимо
географический: географического
положение: положения
искренне: искренне
верить: верим
жизнь: жизнь жизней
иметь: имеет
одинаковый: одинаковую
ценность: ценность
любой: любой
точка: точке точки
помогать: помогаем помогали
трудный: трудно
невозможно: невозможно
получить: получить
удаленный: удаленных
делать: делаем
сила: силами
средство: средствами
волонтер: волонтеров волонтеры
донор: доноров
наш: наша наши наших нашей нашу
деятельность: деятельность
напрямую: напрямую
цур: цур
хороший: хорошее
здоровье: здоровье здоровья
благополучие: благополучие
обслуживание: обслуживанию
влиять: влияет
один: одного одна одном одной
процветание: процветание
сообщество: сообщества сообществ сообществу
целый: целом целей
социальный: социальном
план: плане планы
почему: почему
решить: решили
принять: принять
участие: участие участия
саммит: саммите саммита саммит
будущее: будущего будущее будущих
какой: какие каким
ожидание: ожидания
увидеть: увидела увидели
онлайн: онлайн
отслеживать: отслеживала
первый: первый первую
подобный: подобный
форум: форум
принимать: принимали
день: днях дней дне
действие: действий
сам: самом самого сами
ожидать: ожидаем
смочь: сможем смогли
близкий: ближе
познакомиться: познакомиться
партнер: партнерами партнеров
интересный: интересна
крепкий: крепкие
связь: связи
что: чему
улучшиться: улучшится
деревня: деревнях деревне
интересовать: интересует
корпоративный: корпоративное
партнерство: партнерство партнерств партнерства
агентство: агентствами
сказать: сказала сказать сказали
превосходить: превосходят
задумать: задумали
изначально: изначально
участвовать: участвовали
какой-то: какие-то какой-то каких-то
впечатление: впечатления
параллельный: параллельные
сразу: сразу
заметить: заметили
понять: поняли
отличный: отличная
нетворкинга: нетворкинга
дать: дало данных
мы: нам
уникальный: уникальную уникальным
правительство: правительства
рассказывать: рассказывали рассказывала
поддержка: поддержке
подростковый: подростков
ребенок: дети
фокусный: фокусных
работа: работы
рассчитывать: рассчитываем
сделать: сделать
какой-либо: какую-либо какой-либо
совместный: совместную совместная
программа: программу программы
оказывать: оказываем
просвещать: просвещаем
население: население
вопрос: вопросах вопросы
планирование: планирования планированию
семья: семьи
надежда: надежды
такой: такие таких таком такая такого такую
дело: деле
небольшой: небольшой небольшая
уровень: уровня
ассамблея: ассамблея
расширение: расширения
сеть: сетей сети
новый: новых нового
стратегический: стратегических стратегические
кроме: кроме
действительно: действительно
являться: являемся являются
голос: голосом голос
регион: регионах
единственный: единственной единственным
рада: рады
также: также
поделиться: поделиться
свое: своим
опыт: опытом опыт
строительство: строительства
очень: очень
надеяться: надеемся
рамка: рамках
спасибо: спасибо
найти: найти
собственный: собственно
центральный: центральной центральная
безусловно: безусловно
часть: частью частей
экосистема: экосистемы
мировой: мирового
каждый: каждый
по-своему: по-своему
вносить: вносит
вклад: вклад
достижение: достижение достижению
послание: посланием послание
приехать: приехали
сюда: сюда
готовить: готовили
подавать: подавали
заявка: заявку
интерактивный: интерактивных
диалог: диалогов
обсуждаться: обсуждаются
повлиять: повлиять
текущий: текущую
повестка: повестку
рассматривать: рассматриваем
очередь: очередь
зрение: зрения
поэтому: поэтому
таки: таки
слово: слово
идея: идей
развивать: развивать
частное: частные
разный: разных
момент: моментах
дорогой: дорог
обеспечение: обеспечения
смотреть: смотреть
кажется: кажется
несмотря: несмотря
довольный: довольно
большой: большой большое
нуль: нуля
учреждение: учреждения учреждением
возможно: возможно
распределять: распределяя
ресурс: ресурсы
предоставление: предоставление предоставлением
спасти: спасти
больший: большее
создание: создание
зависимость: зависимости
место: места местом месте
родиться: родился
проживать: проживает проживают
уверить: уверены
вместе: вместе
неправительственный: неправительственных
делегат: делегатами
различный: различными
структура: структурами
посодействовать: посодействует
тот: тому той тех
прийти: придем
приятный: приятным
находиться: находятся находится
деревенька: деревеньке
название: названием
чуинахтахуюп: чуинахтахуюп
гористый: гористой
местность: местности
современный: современные
потомок: потомки
индеец: индейцев
майя: майя
расположить: расположена
буквальный: буквально
джунгли: джунглях
скажем: скажем
сальвия: сальвия
беречь: берегу
залив: залива
фонсека: фонсека
порядок: порядка
пять: пяти
сложный: сложных
условие: условиях условия
электричество: электричества
чистый: чистой чистую
питьевой: питьевой питьевую
вод: воде воду
логистический: логистической
доступность: доступности
важный: важно
создать: создать
поколенье: поколений
уверенность: уверенность
завтрашний: завтрашнем
раз-таки: раз-таки
оба: обоих
принцип: принципе
заниматься: занимается
усилие: усилию
неравнодушный: неравнодушных
благотворитель: благотворителей
планет: планеты
континент: континентов
исключение: исключением
антарктида: антарктиды
максимально: максимально
должен: должны
умирать: умирать
излечимый: излечимых
добавить: добавила добавить
местный: местные местное
время: время
понимать: понимали
значимость: значимость
плюс: плюс
медсестра: медсестры медсестер
необходимо: необходимо
проводить: проводим
образовательный: образовательные
сексуальный: сексуальному
далее: далее
контроль: контролю
рождаемость: рождаемости
обучать: обучаем
случай: случаях
грамотный: грамотными
легкий: легче
простой: проще
предоставлять: предоставлять
услуга: услуги
лечение: лечение
отмечать: отмечала
говорить: говорить говорила
содействовать: содействуем
учет: учетом
система: системы
очистки: очистки
воды: воды
установить: установлена
наверное: наверное
хотеть: хотела хотят хотим
видимый: видим
определить: определенную
несправедливость: несправедливость
искать: ищем
виноватый: виноватых
решение: решения решением
иной: иных
проблема: проблем
добровольный: добровольных
начало: началах
стоять: стоять
сторона: стороне
суть: сути
движение: движения
замечательный: замечательную
читать: читайте
молодежь: молодежи молодежью
относиться: относились
серьезный: серьезно
подписываться: подписывайтесь
рассылка: рассылку
загружать: загружайте
приложение: приложение
мобильный: мобильных
устройство: устройств
воз: воз
отправить: отправила
экстренный: экстренную
пострадать: пострадавших
ход: ходе
нагорно-карабахский: нагорно-карабахского
конфликт: конфликта
молодая: молодая
экоактивистка: экоактивистка
изменение: изменении
-летняя: -летняя
активистка: активистка
украина: украины
процент: процентов
украинский: украинской
информация: информация
новостной: новостные
анонс: анонсы
журнал: журнал
отчет: отчеты
заседание: заседаниях
аудиовизуальный: аудиовизуальные
материал: материалы
общение: общение
твиттер: твиттер
последний: последние
главное: главные
брифинг: брифингов
стенограмма: стенограммы
комментарий: комментарии
журналист: журналистов
интернет: интернете
фейсбук: фейсбук
вконтакте: вконтакте
контакт: контакты
пользоваться: пользоваться
сайт: сайтом
указатель: указатель
часто: часто
задавать: задаваемые
остерегаться: остерегайтесь
мошенничество: мошенничества
конфиденциальность: конфиденциальность
пользование: пользования
пожертвование: пожертвования