невидимый: невидимый
убийца: убийца
такой: такое такие
устойчивость: устойчивость устойчивости устойчивостью
противомикробный: противомикробным противомикробных противомикробные противомикробными противомикробная противомикробной
препарат: препаратам препаратов препараты препаратами препаратах
новость: новости
оон: оон
перейти: перейти
основное: основному
добро: добро
пожаловать: пожаловать
русский: русский
другой: другие других
глобальный: глобальный глобальные глобальная
взгляд: взгляд
человеческий: человеческие
судьба: судьбы
поиск: поиск
расширить: расширенный
язык: язык
меню: меню
главный: главная
азия: азия
америка: америка
африка: африка
ближний: ближний
восток: восток
европа: европа
тема: темы теме
гуманитарный: гуманитарная
помощь: помощь
беженец: беженцы
мигрант: мигранты
женщина: женщины
здравоохранение: здравоохранение здравоохранения
климат: климат
окружать: окружающая окружающей
среда: среда среды
культура: культура
образование: образование образованию
международный: международное международные
правый: право права
мир: мир миру мире
безопасность: безопасность
генеральный: генеральный генеральной генерального
секретарить: секретарь секретаря
человек: человека людей человеку человек люди
цель: цели
устойчивый: устойчивого устойчивых устойчивыми
развитие: развития развитие
экономический: экономическое
подробный: подробнее
интервью: интервью
сюжет: сюжеты
экспресс-новости: экспресс-новости
фоторепортаж: фоторепортажи
пресс-секретарь: пресс-секретарь
выступление: выступления
заявление: заявления
пресса: прессой
официальный: официальные официальным
поездка: поездки
фотография: фотографии
пресс-релиз: пресс-релизы
группа: группа
аккредитация: аккредитации
сми: сми
интернет-трансляция: интернет-трансляция
аудиотека: аудиотека
подписаться: подписаться
центр: центр
контроль: контролю
заболевание: заболеваниями заболеваний
сша: сша
бактерия: бактерия бактерий
туберкулез: туберкулеза
который: которая которое которые который которых
выработать: выработала
лекарство: лекарствам лекарства
печать: печать
сентябрь: сентября
упп: упп
увидеть: увидеть
невооруженный: невооруженным
глаз: глазом
являться: является являются
непосредственный: непосредственной
причина: причиной причин
миллион: миллиона миллионов миллионам
смерть: смертей
один: одним
фактор: факторов
пять: пяти
смертельный: смертельных смертельному
случай: случаев
каждый: каждый
год: год году
существовать: существует существующими существующим
множество: множество
способ: способов
борьба: борьбы борьбе
угроза: угрозой угрозу
число: числе число
мера: меры
гигиена: гигиены
санитария: санитарии
вакцинация: вакцинация
усилие: усилия
предотвращение: предотвращению
чрезмерный: чрезмерного чрезмерное
неправильный: неправильного
использование: использования использование использованию использовании использованием
второе: второе
совещание: совещание совещании
высокий: высокого
уровень: уровня
проблема: проблеме проблема проблемой
состояться: состоится
стать: станет станут
главное: главным главные
мероприятие: мероприятием
посвятить: посвященным
рамка: рамках
неделя: недели
сессия: сессии
ассамблея: ассамблеи
организация: организации организация
объединить: объединенных
нация: наций
узнать: узнайте
важный: важнейшие
факт: факты
наш: нашем нашу наши
материал: материале материалы
антибиотик: антибиотики антибиотиков антибиотиками антибиотикам
противовирусный: противовирусные
противогрибковый: противогрибковые
противопаразитарный: противопаразитарные
средство: средства
значительно: значительно
увеличить: увеличили
средний: среднюю
продолжительность: продолжительность
жизнь: жизни
момент: момента
открытие: открытия
помогать: помогают
деть: день
однако: однако
результат: результате
лекарственный: лекарственные лекарственным лекарственной лекарственно лекарственных
утрачивать: утрачивают
эффективность: эффективность
возкматтингли: возкматтингли
возникать: возникает
постепенный: постепенной
мутация: мутации мутаций
вирус: вирусов
грибок: грибков
паразит: паразитов
утрата: утраты утрате
они: ими ними
восприимчивость: восприимчивости
затруднять: затрудняет
лечение: лечение лечению лечения
инфекция: инфекций инфекция инфекции инфекциями инфекциям
повышать: повышает
риск: риски
распространение: распространения распространение распространению
тяжелый: тяжелого
течение: течения
летальный: летального
исход: исхода исходу
болезный: болезней
незначительный: незначительная
травма: травма
рутинный: рутинная
операция: операция операции
обычный: обычная
мочь: могут могли
неожиданно: неожиданно
перерасти: перерасти
опасный: опасную
ситуация: ситуацию
привести: привести
длительный: длительной
болезнь: болезни
трудоспособность: трудоспособности трудоспособность
ставить: ставит
достигнутый: достигнутый
последний: последнее последние
столетие: столетие
прогресс: прогресс
область: области
медицина: медицины
вернуть: вернуть
эпоха: эпоху
появление: появления появление
сегодня: сегодня
поддаваться: поддаются поддающиеся
равносильный: равносильны
смертный: смертному
приговор: приговору
заявить: заявил
директор: директор
воз: воз
тедрос: тедрос
адханом: адханом
гебрейесус: гебрейесус
выступить: выступит
этот: эта этими
создавать: создает
страна: стран
независимо: независимо
доход: дохода
поэтому: поэтому
крайне: крайне
необходимый: необходимы
неотложный: неотложные
решительный: решительные
быстрый: быстрые быстрое
скоординировать: скоординированные
ответный: ответные
развиваться: развивается
время: временем
естественный: естественным
образ: образом
обычно: обычно
генетический: генетических
несколько: несколько
ускорять: ускоряют
резистентность: резистентности
ключевой: ключевыми
отсутствие: отсутствие
необходимость: необходимости
назначение: назначение
медицинский: медицинскими медицинских медицинские
работник: работниками
незавершенный: незавершенные
курс: курсы
фаол: фаол
тато: тато
сельский: сельском
хозяйство: хозяйстве
профилактика: профилактики профилактике
стимулирование: стимулирования
рост: роста рост
животное: животных
штамм: штаммов
передаваться: передаваться
кроме: кроме
неадекватный: неадекватные
санитарно-гигиенический: санитарно-гигиенические
условие: условия
учреждение: учреждениях
сельхоз: сельхоз
предприятие: предприятиях
способствовать: способствуют
микроорганизм: микроорганизмов микроорганизмах
торговля: торговля
путешествие: путешествия
позволять: позволяют
патоген: патогенам патогенов
распространяться: распространяться
все: всему
последствие: последствия
заболеваемость: заболеваемости заболеваемостью
иметь: имеет иметь
серьезный: серьезные серьезно
индивидуальный: индивидуального
общественный: общественного
здоровье: здоровья
также: также
влиять: влияет
продовольственный: продовольственную
помимо: помимо
наносить: наносит
значительный: значительный
урон: урон
экономика: экономике
система: системам систем
уменьшать: уменьшает
пациент: пациентов
ухаживать: ухаживающих
лицо: лиц
связь: связи
удлинение: удлинением
срок: сроков
госпитализация: госпитализации
потребность: потребностью потребности
дорогостоящий: дорогостоящих
интенсивный: интенсивных
вид: видах
терапия: терапии
оценка: оценкам
всемирный: всемирного всемирная
банк: банка
ежегодный: ежегодные
потеря: потери
составить: составить
триллион: триллиона
доллар: долларов
оказаться: окажутся
черта: чертой
бедность: бедности
связанный: связанных
возэивонн: возэивонн
невосприимчивый: невосприимчивых
выработаться: выработались
новый: новые новым новое
механизм: механизмы
продолжать: продолжают
ограничивать: ограничивать
возможность: возможности
распространить: распространенных
особенно: особенно
тревожный: тревожной
тенденция: тенденцией
множественный: множественной
тотальный: тотальной
называть: называемых
супербактерий: супербактерий
вызывать: вызывают
частность: частности
эффективный: эффективных эффективным
инструмент: инструментов инструментом
надлежащий: надлежащего
расширение: расширения
доступ: доступа
качественный: качественным
излечиваться: излечивающихся
умирать: умирающих
расти: расти
рискованный: рискованными
вмешательство: вмешательства
хирургический: хирургические
кесарев: кесарево
сечение: сечение
эндопротезирование: эндопротезирование
тазобедренный: тазобедренного
сустав: сустава
химиотерапия: химиотерапия
онкологический: онкологических
трансплантация: трансплантация
орган: органов
план: план
действие: действий
партнер: партнеры партнеров
принять: приняли принять
активизировать: активизировали
работа: работу
повышение: повышению
осведомленность: осведомленности
ответственный: ответственному
исследование: исследованиям
возспабст: возспабст
комплексный: комплексной
требовать: требует
коллективный: коллективного
многосекторального: многосекторального
подход: подхода
осуществлять: осуществляет
мониторинг: мониторинг
представлять: представляет
отчетность: отчетность
предоставлять: предоставляет
обновить: обновленную
информация: информацию информация
снижение: снижение
путем: путем
укрепление: укрепления
счет: счет
всеобщий: всеобщего
охват: охвата
услуга: услугами
приоритетный: приоритетного
внимание: внимания
иммунизация: иммунизации
программа: программам
водоснабжение: водоснабжения
подписываться: подписывайтесь
рассылка: рассылку
загружать: загружайте
приложение: приложение
мобильный: мобильных
устройство: устройств
собраться: собравшиеся
нью-йорк: нью-йорке
мировой: мировые
лидер: лидеры
пообещать: пообещали
выпустить: выпустила
первое: первое первые
руководство: руководство
управление: управлению
отходы: отходами
производство: производства
глава: глава
призвать: призвал
защитить: защитить
защищать: защищают
вторник: вторник
опубликовать: опубликовала
свое: свое
фармацевтический: фармацевтическими
позволить: позволит
снизить: снизить
масштаб: масштабы
загрязнение: загрязнения
помочь: поможет
предотвратить: предотвратить
представить: представила
больница: больницах
мая: мая
процент: процентов
стационарный: стационарных
нуждаться: нуждаются
катетер: катетера катетеров
вводить: вводят
периферический: периферическую
вено: вену
артерия: артерию
уязвимый: уязвимы
больной: больны
низкий: низкий
иммунитет: иммунитет
рекомендация: рекомендации
кровоток: кровотока
внутрисосудистый: внутрисосудистых
ход: ходе
процедура: процедур
ресурс: ресурсы
новостной: новостные
анонс: анонсы
журнал: журнал
отчет: отчеты
заседание: заседаниях
аудиовизуальный: аудиовизуальные
общение: общение
твиттер: твиттер
брифинг: брифингов
стенограмма: стенограммы
комментарий: комментарии
журналист: журналистов
интернет: интернете
фейсбук: фейсбук
вконтакте: вконтакте
контакт: контакты
пользоваться: пользоваться
сайт: сайтом
указатель: указатель
часто: часто
задавать: задаваемые
вопрос: вопросы
остерегаться: остерегайтесь
мошенничество: мошенничества
конфиденциальность: конфиденциальность
пользование: пользования
пожертвование: пожертвования