воз: воз
вакцинация: вакцинации вакцинацией вакцинация
полиомиелит: полиомиелита полиомиелит
газ: газе газы газу газа
готовый: готово готовых
новость: новости
оон: оон
перейти: перейти
основное: основному
добро: добро
пожаловать: пожаловать
русский: русский
другой: другие другими
глобальный: глобальный
взгляд: взгляд
человеческий: человеческие
судьба: судьбы
поиск: поиск
расширить: расширенный
язык: язык
меню: меню
главный: главная
азия: азия
америка: америка
африка: африка
ближний: ближний ближайшее
восток: восток
европа: европа
тема: темы теме
гуманитарный: гуманитарная гуманитарные гуманитарных
помощь: помощь помощи
беженец: беженцы беженцев
мигрант: мигранты
женщина: женщины
здравоохранение: здравоохранение здравоохранения
климат: климат
окружать: окружающая
среда: среда
культура: культура
образование: образование
международный: международное
правый: право права
мир: мир
безопасность: безопасность безопасности
генеральный: генеральный генерального
секретарить: секретарь секретаря
человек: человека человек
цель: цели
устойчивый: устойчивого
развитие: развития развитие
экономический: экономическое
подробный: подробнее
интервью: интервью
сюжет: сюжеты
экспресс-новости: экспресс-новости
фоторепортаж: фоторепортажи
пресс-секретарь: пресс-секретарь
выступление: выступления
заявление: заявления
пресса: прессой
официальный: официальные
поездка: поездки
фотография: фотографии
пресс-релиз: пресс-релизы
группа: группа
аккредитация: аккредитации
сми: сми
интернет-трансляция: интернет-трансляция
аудиотека: аудиотека
подписаться: подписаться
бапор: бапор
передаваться: передается
заразить: зараженную
вирус: вирусом
вод: воду
печать: печать
август: августа
учреждение: учреждения учреждений
достигнуть: достигли достичь
предварительный: предварительной предварительное
договоренность: договоренности
все: всеми всем
сторона: сторонами стороны
конфликт: конфликта
организация: организации организация
серия: серии серия
пауза: пауз паузы
время: время
проведение: проведения
массовый: массовой массовая
кампания: кампании кампания кампанию
это: это
позволить: позволит
привить: привить привьет
тысяча: тысяч тысячи
ребенок: детей детям
сообщить: сообщила сообщил
пятница: пятницу
всемирный: всемирная
представитель: представитель представителя представители
оккупировать: оккупированных
палестинский: палестинских
территория: территориях
рика: рик
пиперкорн: пиперкорн
двухэтапная: двухэтапная
начаться: начнется
воскресенье: воскресенье
центральный: центральной
частить: части
продлиться: продлится
день: дня
затем: затем
переместиться: переместится
южный: южные
северный: северные
район: районы районах
второй: вторая
фаза: фаза
стартовать: стартует
четыре: четыре
неделя: недели неделе
каждый: каждого
раунд: раунда
министерство: министерство
палестина: палестины
сотрудничество: сотрудничестве
юнисеф: юнисеф
агентство: агентством агентств
дело: делам
партнер: партнерами партнеров
новый: новой
оральный: оральной
полиомиелитный: полиомиелитной
вакцина: вакциной вакцины
возраст: возрасте
год: лет
доктор: доктор
доставить: доставлены
миллион: миллиона
доза: доз
прибыть: прибудут
сектор: сектор секторе
выступать: выступая
видеосвязи: видеосвязи
приветствовать: приветствовал
обязательство: обязательство
израильский: израильских израильской
военный: военных военной
соблюдать: соблюдать
конкретный: конкретных
призывать: призываем
приостановить: приостановить
боевой: боевые
действие: действия действиями
дать: дать
возможность: возможность
семья: семьям
безопасно: безопасно
добраться: добраться
медицинский: медицинских медицинской
медик: медикам
который: которые которое
мочь: могут
попасть: попасть
пункт: пункты пункта
сказать: сказал
иметь: имеет
первостепенный: первостепенное
значение: значение
остановить: остановить
вспышка: вспышку
предотвратить: предотвратить
распространение: распространение
смертельный: смертельно
опасный: опасного
заболевание: заболевания
способный: способно
вызвать: вызвать
пожизненный: пожизненный
паралич: паралич
необходимо: необходимо
охватить: охвачено охваченном
менее: менее
процент: процентов
население: населения населением
работник: работников
специалист: специалистов
работа: работе
поддержать: поддержать
подчеркнуть: подчеркнул
быть: будут
населенный: населенных
примерный: примерно
мобильный: мобильными мобильных
бригада: бригадами бригад
слово: словам
идеальный: идеальная
схема: схема
согласовать: согласована
сделать: сделаем
возможный: возможное
-процентного: -процентного
охват: охвата
добавить: добавил
операция: операция операции
западный: западном
беречь: берегу
фон: фоне
четвертый: четвертого
выразить: выразили
обеспокоенность: обеспокоенность
повод: поводу
мирный: мирных
житель: жителей
оказывать: оказывают
беспрепятственный: беспрепятственный
доступ: доступ
нуждаться: нуждающимся
решающий: решающее
оказание: оказания
доставка: доставки
медикамент: медикаментов
защитить: защитить
инфраструктура: инфраструктуру
машина: машины
скорый: скорой
также: также
пространство: пространство
больница: больниц
результат: результате
рейдовый: рейдов
сила: сил
густонаселенный: густонаселенных
дженине: дженине
тулькареме: тулькареме
погибнуть: погибли
меньший: меньшей
мера: мере
начало: начала
война: войны
восточный: восточном
иерусалим: иерусалиме
убить: убиты
палестинец: палестинца
число: числе
пять: пяти
получить: получили
ранение: ранения
подписываться: подписывайтесь
наш: нашу наши
рассылка: рассылку
загружать: загружайте
приложение: приложение
устройство: устройств
боев: боевыми
север: севере
анклав: анклава
удаться: удалось
генсек: генсек
объявить: объявил
подготовка: подготовке
масштабный: масштабной
возобновиться: возобновится
ресурс: ресурсы
информация: информация
новостной: новостные
анонс: анонсы
журнал: журнал
отчет: отчеты
заседание: заседаниях
аудиовизуальный: аудиовизуальные
материал: материалы
общение: общение
твиттер: твиттер
последний: последние
главное: главные
брифинг: брифингов
стенограмма: стенограммы
комментарий: комментарии
журналист: журналистов
интернет: интернете
фейсбук: фейсбук
вконтакте: вконтакте
контакт: контакты
пользоваться: пользоваться
сайт: сайтом
указатель: указатель
часто: часто
задавать: задаваемые
вопрос: вопросы
остерегаться: остерегайтесь
мошенничество: мошенничества
конфиденциальность: конфиденциальность
условие: условия
пользование: пользования
пожертвование: пожертвования