правый: права право прав
человек: человека человек людей
ключ: ключ
искоренение: искоренению искоренении
спид: спида спидом
новый: новый новых
доклад: доклад докладе
юнэйдс: юнэйдс
новость: новости
оон: оон
перейти: перейти
основное: основному
добро: добро
пожаловать: пожаловать
русский: русский
другой: другие
глобальный: глобальный глобальная глобальной
взгляд: взгляд взглядами
человеческий: человеческие
судьба: судьбы
поиск: поиск
расширить: расширенный
язык: язык
меню: меню
главный: главная
азия: азия азии
америка: америка
африка: африка африки
ближний: ближний
восток: восток
европа: европа европе европы
тема: темы теме
гуманитарный: гуманитарная
помощь: помощь помощи
беженец: беженцы
мигрант: мигранты
женщина: женщины женщинах женщин
здравоохранение: здравоохранение здравоохранения
климат: климат
окружать: окружающая
среда: среда
культура: культура
образование: образование образовании образования
международный: международное
мир: мир миру мира мире
безопасность: безопасность безопасности
генеральный: генеральный генерального
секретарить: секретарь секретаря
цель: цели
устойчивый: устойчивого
развитие: развития развитие
экономический: экономическое
подробный: подробнее
интервью: интервью
сюжет: сюжеты
экспресс-новости: экспресс-новости
фоторепортаж: фоторепортажи
пресс-секретарь: пресс-секретарь
выступление: выступления
заявление: заявления
пресса: прессой
официальный: официальные
поездка: поездки
фотография: фотографии
пресс-релиз: пресс-релизы
группа: группа группе групп
аккредитация: аккредитации
сми: сми
интернет-трансляция: интернет-трансляция
аудиотека: аудиотека
подписаться: подписаться
юнисефоасселен: юнисефоасселен
миллион: миллиона
жить: живущих
вич: вич
иметь: имеют
доступ: доступа доступ
жизненно: жизненно
необходимый: необходимому необходимым необходимы необходимой
лечение: лечению лечения
печать: печать
ноябрь: ноября
опубликовать: опубликованный
накануне: накануне
всемирный: всемирного
день: дня
борьба: борьбы
подтверждать: подтверждает
соблюдение: соблюдение
играть: играет
важный: важную
роль: роль
пандемия: пандемии
организация: организация
призывать: призывает призывают
мировой: мировых мирового мировое
лидер: лидеров
защитить: защитить
тот: тех
находиться: находится
риск: риска риск
достигнуть: достичь
прекращение: прекращения
угроза: угрозы
общественный: общественному
здоровье: здоровью здоровье
год: году лет год года
равенство: равенство
озаглавить: озаглавленный
выбрать: выбрать
путь: путь пути
покончить: покончить
подчеркивать: подчеркивает
правовой: правовые
барьер: барьеры
дискриминация: дискриминация дискриминации
оставаться: остаются оставаться
главное: главными главные
препятствие: препятствиями
победа: победе победы
эпидемия: эпидемией эпидемии
несмотря: несмотря
огромный: огромный
прогресс: прогресс
достигнутый: достигнутый
противодействие: противодействии
нарушение: нарушения
мешать: мешают
заявить: заявила
винни: винни
бьянима: бьянима
исполнительный: исполнительный
директор: директор
девочка: девочкам девочка девочек
отказывать: отказывают
существовать: существует
безнаказанность: безнаказанность
гендерный: гендерное
насилие: насилие
арестовывать: арестовывают
кто: кем кого
являться: являются является
любить: любят
это: это
лишать: лишает
услуга: услугам
каждый: каждого
должен: должны должна должен
цифра: цифры
который: которые
требовать: требуют
действие: действий действия
сегодняшний: сегодняшний
деть: день
болезный: болезней
связанный: связанных
умереть: умерло
тысяча: тысяч
заразиться: заразились
меньший: меньшей
мера: мере
страна: странах
число: число
случай: случаев
вич-инфекция: вич-инфекции
расти: растет
особенно: особенно
тревожный: тревожны
дать: данные
девушка: девушках
ежедневно: ежедневно
молодая: молодых
возраст: возрасте
инфицироваться: инфицируются
некоторые: некоторых
заражение: заражения
раз: раза
высокий: выше
сверстников-мужчин: сверстников-мужчин
активистка: активистка
движение: движения
номонде: номонде
нгема: нгема
один: одна
лишить: лишена
информация: информации информация
чрезвычайный: чрезвычайная
ситуация: ситуация
область: области
стигма: стигма
обращать: обращает
внимание: внимание
криминализация: криминализацию
стигматизация: стигматизацию
уязвимый: уязвимых
значительно: значительно
ограничивать: ограничивают
медицинский: медицинским медицинские
однополые: однополые
отношение: отношения
сей: сих
пора: пор
криминализованы: криминализованы
повышать: повышает
уровень: уровень
лгбт-сообществ: лгбт-сообществ
карательный: карательные
закон: законы
удерживать: удерживают
профилактика: профилактики
отметить: отметил
аксель: аксель
баутиста: баутиста
вместо: вместо
наказывать: наказывать
маргинализированные: маргинализированные
сообщество: сообщества сообщество
правительство: правительства
отстаивать: отстаивать
иновации: иновации
справедливость: справедливость
научный: научные
достижение: достижения достижение
такой: такие таких
лекарство: лекарства
длительный: длительного
вводить: вводимые
несколько: несколько
давать: дают
надежда: надежду
завершение: завершение
однако: однако
эффективность: эффективность
зависеть: зависит
доступность: доступности
технология: технологии
спасать: спасают
жизнь: жизни
мочь: могут
рассматриваться: рассматриваться
просто: просто
товар: товар
сказать: сказала
александр: александра
калми: калми
специалист: специалист
революционный: революционные
метод: методы
доступный: доступны
все: всем
задержка: задержек
вызов: вызов
подчеркнуть: подчеркнула
жанна: жанна
гапия-нийонзима: гапия-нийонзима
основательница: основательница
первый: первый
бурунди: бурунди
публичный: публично
объявить: объявивший
свое: своем своими
вич-положительном: вич-положительном
статус: статусе
хотеть: хочет
защищать: защищать
также: также
включать: включает
эссе: эссе
элтон: элтон
джон: джон
архиепископ: архиепископ
кейптаун: кейптауна
табо: табо
макгоба: макгоба
президент: президент
ирландия: ирландии
майкл: майкл
хиггинс: хиггинс
делиться: делятся
необходимость: необходимость
защита: защиты защита
продолжать: продолжает
вдохновлять: вдохновлять
три: трех
нуль: нулей
ноль: ноль
инфекция: инфекций
смерть: смертей
успех: успеха
требоваться: требуется
стать: стала
основа: основой
стратегия: стратегии
подписываться: подписывайтесь
наш: нашу наши
рассылка: рассылку
загружать: загружайте
приложение: приложение
мобильный: мобильных
устройство: устройств
вичспид: вичспид
знать: знай
свой: свой
диагноз: диагноз
объединить: объединенной
программа: программе программы
альянс: альянс
ребенок: детей
возможно: возможно
процент: процента
восточный: восточной
центральный: центральной
приходиться: приходятся
россия: россию
украина: украину
узбекистан: узбекистан
казахстан: казахстан
июль: июля
половина: половина
лишь: лишь
регион: регионе
подавить: подавленную
вирусный: вирусную
нагрузка: нагрузку
самый: самым
низкий: низким
показатель: показателем
проводиться: проводятся
последний: последнем последние
ресурс: ресурсы
партнер: партнеров
новостной: новостные
анонс: анонсы
журнал: журнал
отчет: отчеты
заседание: заседаниях
аудиовизуальный: аудиовизуальные
материал: материалы
общение: общение
твиттер: твиттер
брифинг: брифингов
стенограмма: стенограммы
комментарий: комментарии
журналист: журналистов
интернет: интернете
фейсбук: фейсбук
вконтакте: вконтакте
контакт: контакты
пользоваться: пользоваться
сайт: сайтом
указатель: указатель
часто: часто
задавать: задаваемые
вопрос: вопросы
остерегаться: остерегайтесь
мошенничество: мошенничества
конфиденциальность: конфиденциальность
условие: условия
пользование: пользования
пожертвование: пожертвования