воз: воз
конвенция: конвенции конвенция конвенцию конвенцией
табак: табака табаком табак
удаться: удалось
спасти: спасти
миллион: миллионы миллионам
жизнь: жизней
новость: новости
оон: оон
перейти: перейти
основное: основному
добро: добро
пожаловать: пожаловать
русский: русский
другой: другие
глобальный: глобальный
взгляд: взгляд
человеческий: человеческие человеческих
судьба: судьбы
поиск: поиск
расширить: расширенный
язык: язык
меню: меню
главный: главная
азия: азия
америка: америка
африка: африка
ближний: ближний
восток: восток
европа: европа европе
тема: темы теме
гуманитарный: гуманитарная
помощь: помощь
беженец: беженцы
мигрант: мигранты
женщина: женщины
здравоохранение: здравоохранение здравоохранения
климат: климат
окружать: окружающая окружающую
среда: среда среды среду
культура: культура
образование: образование
международный: международное международного
правый: право права
мир: мир мире мира
безопасность: безопасность
генеральный: генеральный генерального
секретарить: секретарь секретаря
человек: человека человек
цель: цели
устойчивый: устойчивого
развитие: развития развитие
экономический: экономическое
подробный: подробнее
интервью: интервью
сюжет: сюжеты
экспресс-новости: экспресс-новости
фоторепортаж: фоторепортажи
пресс-секретарь: пресс-секретарь
выступление: выступления
заявление: заявления
пресса: прессой
официальный: официальные
поездка: поездки
фотография: фотографии
пресс-релиз: пресс-релизы
группа: группа
аккредитация: аккредитации
сми: сми
интернет-трансляция: интернет-трансляция
аудиотека: аудиотека
подписаться: подписаться
фото: фото
архив: архива
употребление: употребление употребления
являться: является являются
один: одним одной
основной: основных
фактор: факторов
неинфекционный: неинфекционных
заболевание: заболеваний
вызывать: вызывающих
преждевременный: преждевременную
смерть: смерть смертей
печать: печать
февраль: февраля
последний: последние
десятилетие: десятилетия
табачный: табачных табачные табачной табачная
изделие: изделий изделия
снизиться: снизилось
треть: треть
сообщать: сообщают
всемирный: всемирной
организация: организации
напоминать: напоминают
важный: важнейшую важная важную
роль: роль
сыграть: сыграла
рамочный: рамочная
борьба: борьбе
неделя: неделе
исполняться: исполняется
год: лет
момент: момента
вступление: вступления
сила: силу
это: это
первый: первый
история: истории
договор: договор
область: области
общественный: общественного общественных
заключенный: заключенный
эгида: эгидой
сторона: сторонами сторонам
государство: государств
который: которых которые которая
проживать: проживает
процент: процентов
житель: жителей
планет: планеты
представлять: представляет
себя: собой
правовой: правовую правовой
основа: основу
комплексный: комплексный
пакет: пакет
мера: мер мере
помочь: помогли поможет
закон: законы
запрещать: запрещающие
курение: курение курению курения
место: местах
введение: введение
повышенный: повышенных
налоговый: налогов
использование: использование
графический: графических графические
предупреждение: предупреждений предупреждения
вред: вреде
здоровье: здоровья
пачка: пачках
сигарета: сигарет сигареты
чума: чума
человечество: человечества
причина: причина
болезный: болезней
все: всем
предотвратить: предотвратить
сказать: сказал сказала
тедрос: тедрос
адханом: адханом
гебрейесус: гебрейесус
директор: директор
веха: веха
продолжать: продолжаем
призывать: призывать
страна: страны стран
дальнейший: дальнейшему
усиление: усилению
внедрение: внедрению
предложить: предложенных
добавить: добавил добавила
призвать: призвал
ратифицировать: ратифицировали
сделать: сделать
скорый: скорее
сегодня: сегодня
коло: коло
миллиард: млрд миллиардов
находиться: находятся
защита: защитой защиты защите
крайний: крайней
предусмотренный: предусмотренных
требовать: требуют
размещать: размещать
крупный: крупные
десятка: десятки
ввести: ввели
требование: требование
компания: компаний
продавать: продавать
простоять: простой
упаковка: упаковке
брендинга: брендинга
дизайн: дизайна
логотип: логотипа
читать: читайте
также: также
европейский: европейское
бюро: бюро
представить: представило
обновить: обновленные
дать: данные
регион: регионе
четверть: четверти
население: населения
настоящее: настоящее
время: время
защитить: защищено
политика: политикой
бездымный: бездымной
запрет: запрета запреты
помещение: помещениях
реклама: рекламу
продвижение: продвижение
установление: установлении
лицо: лицом
агрессивный: агрессивных
кампания: кампаний кампания
промышленность: промышленности промышленность
тратить: тратит
доллар: долларов
свой: своей
продукция: продукции
активно: активно
подрывать: подрывает подрывая
усилие: усилия
губительный: губительная
отрасль: отрасль отрасли
стоить: стоящая
эпидемия: эпидемией
пытаться: пытается
позиционировать: позиционировать
часть: часть
решение: решения
мочь: могли
адриана: адриана
бланко: бланко
маркизо: маркизо
глава: глава
секретариат: секретариата
предоставлять: предоставляет
комплекс: комплекс
постоянно: постоянно
меняться: меняющейся
тактика: тактики
направить: направленной
получение: получение
прибыть: прибыли
счет: счет
наш: нашей нашу наши
инвалидность: инвалидность
очередь: очередь
оборачиваться: оборачивается
огромный: огромными
расход: расходами
сфера: сфере
выращивание: выращивание
отводиться: отводятся
больший: большие
площадь: площади
противный: противном
случай: случае
использоваться: использоваться
производство: производства
продовольствие: продовольствия
триллион: триллионы
окурок: окурков
загрязнять: загрязняют
подписываться: подписывайтесь
рассылка: рассылку
загружать: загружайте
приложение: приложение
мобильный: мобильных
устройство: устройств
менее: менее
охотно: охотно
отказываться: отказываются
мужчина: мужчины
решать: решай
бросать: бросай
новый: новая
бросить: бросить
курить: курить курит
чрезвычайный: чрезвычайных
ситуация: ситуаций
уровень: уровень
возрастать: возрастает
сколько: сколько
украинец: украинцев
ресурс: ресурсы
информация: информация
партнер: партнеров
новостной: новостные
анонс: анонсы
журнал: журнал
отчет: отчеты
заседание: заседаниях
аудиовизуальный: аудиовизуальные
материал: материалы
общение: общение
твиттер: твиттер
главное: главные
брифинг: брифингов
стенограмма: стенограммы
комментарий: комментарии
журналист: журналистов
интернет: интернете
фейсбук: фейсбук
вконтакте: вконтакте
контакт: контакты
пользоваться: пользоваться
сайт: сайтом
указатель: указатель
часто: часто
задавать: задаваемые
вопрос: вопросы
остерегаться: остерегайтесь
мошенничество: мошенничества
конфиденциальность: конфиденциальность
условие: условия
пользование: пользования
пожертвование: пожертвования