насилие: насилие насилия
оккупировать: оккупированных
палестинский: палестинских палестинском палестинские палестинской
территория: территориях
утихать: утихает
новый: новом нового новый
год: году года лет
новость: новости
оон: оон
перейти: перейти
основное: основному
добро: добро
пожаловать: пожаловать
русский: русский
другой: другие
глобальный: глобальный
взгляд: взгляд
человеческий: человеческие
судьба: судьбы
поиск: поиск
расширить: расширенный
язык: язык
меню: меню
главный: главная
азия: азия
америка: америка
африка: африка
ближний: ближний
восток: восток
европа: европа
тема: темы теме
гуманитарный: гуманитарная гуманитарный гуманитарной гуманитарных гуманитарного
помощь: помощь помощи
беженец: беженцы беженцев
мигрант: мигранты
женщина: женщины женщин
здравоохранение: здравоохранение
климат: климат
окружать: окружающая
среда: среда
культура: культура
образование: образование
международный: международное
правый: право права прав
мир: мир
безопасность: безопасность безопасности
генеральный: генеральный генерального
секретарить: секретарь секретаря
человек: человека людей человек
цель: цели
устойчивый: устойчивого
развитие: развития развитие
экономический: экономическое
подробный: подробнее
интервью: интервью
сюжет: сюжеты
экспресс-новости: экспресс-новости
фоторепортаж: фоторепортажи
пресс-секретарь: пресс-секретарь
выступление: выступления
заявление: заявления
пресса: прессой
официальный: официальные официальных
поездка: поездки
фотография: фотографии
пресс-релиз: пресс-релизы
группа: группа
аккредитация: аккредитации
сми: сми
интернет-трансляция: интернет-трансляция
аудиотека: аудиотека
подписаться: подписаться
вппдждюмон: вппдждюмон
авиаудары: авиаудары
город: городе
газ: газа газе газу
центральный: центральной
ухудшить: ухудшили ухудшило
положение: положение
палестинец: палестинцев
бежать: бежавших бежали
туда: туда
северный: северной
частить: части
сектор: сектора секторе
печать: печать
январь: января
по-прежнему: по-прежнему
наблюдаться: наблюдается
вынудить: вынужденное
перемещение: перемещение
кризис: кризис кризиса
сегодня: сегодня
заявить: заявили заявила
офис: офисе офиса
управление: управления
верховный: верховного
комиссар: комиссара
право: правам
увкпч: увкпч
кошмар: кошмар
продолжаться: продолжается продолжаются
отчет: отчете отчета отчету отчеты
говориться: говорится
последний: последние
месяц: месяцев
непрекращающийся: непрекращающихся
атака: атак атаками
погибнуть: погибли погибших
десятка: десятки
тысяча: тысяч
житель: жители
анклав: анклава
многократно: многократно
свое: своих
домовый: домов
убежище: убежищ
никто: никто
спасатель: спасателей
медицинский: медицинских медицинской
работник: работников
журналист: журналистов
полицейский: полицейских полицейского
сотрудник: сотрудников
первый: первая
неделя: неделя
стать: стала стали
исключение: исключением
результат: результате
боев: боевых
действие: действий действия
меньший: меньшей
мера: мере мер
израильский: израильская израильской израильские израильского израильских
армия: армия армии
продолжать: продолжает продолжают
издавать: издавать
уведомление: уведомления
эвакуация: эвакуации
дать: данным
особо: особо
тяжелый: тяжелыми
израиль: израиль израилем
также: также
препятствовать: препятствовать
доставка: доставке
отметить: отметили
автор: авторы
общественный: общественного
порядок: порядка
вызвать: вызванный вызвали
число: числе
гражданский: гражданской
полиция: полиции
затруднять: затрудняет
распределение: распределение
иметься: имеющихся
запас: запасов
начало: начала
зафиксировать: зафиксированы
минимум: минимум
случай: случая
убить: убили убив
охранник: охранников
обеспечивать: обеспечивающих
операция: операций операция
кроме: кроме
суббота: субботу
мародер: мародеры
напасть: напали
колонна: колонну
грузовик: грузовиков
захватить: захватили
западный: западный западном
беречь: берег берегу
река: реки
иордан: иордан
нарушение: нарушения
это: это
включать: включает включая
использование: использование
метод: методов
средство: средств
ведение: ведения
война: войны война
контекст: контекста
применение: применение
смертельный: смертельной
сила: силы сил
безоружный: безоружных безоружными
внесудебный: внесудебные
казнить: казни
разыскивать: разыскиваемых
происходить: происходят
принудительный: принудительные
выселение: выселения
снос: снос
расширение: расширение
незаконный: незаконных
поселение: поселений поселения
жесткий: жесткие
ограничение: ограничения ограничение
передвижение: передвижение
разрушение: разрушение
сообщество: сообществ
беспрецедентный: беспрецедентное
подавление: подавление
свобода: свободы
слово: слова
пресс: прессы
мнение: мнений
ход: ходе
рейдовый: рейдов
девять: девять
четыре: четырех
ребенок: детей дети
мальчик: мальчика
восемь: восьми восемь
десять: десяти
авиаудара: авиаудара
таммуне: таммуне
пятница: пятницу
поселенец: поселенцы
атаковать: атаковали
несколько: несколько
деревня: деревень
поджечь: подожгли
дома: дома
автомобиль: автомобили
серьезный: серьезно серьезную серьезной
ранить: ранив
менее: менее
понедельник: понедельник
вооруженный: вооруженные
лицо: лица лиц
обстрелять: обстреляли
недалекий: недалеко
трое: троих
израильтянин: израильтян
два: двух
пожилой: пожилых
-летнего: -летнего
событие: события
угроза: угрозы угрозу
ответный: ответного
прозвучать: прозвучавшие
сторона: стороны
вызывать: вызывать
обеспокоенность: обеспокоенность
представитель: представители
лагер: лагере
дженин: дженин
начаться: начавшаяся
декабрь: декабря
привести: привела
гибель: гибели
большинство: большинство
который: которых
шесть: шести
служба: служб
отец: отец
-летний: -летний
сын: сын
застрелить: застреленные
отрицать: отрицают
причастность: причастность
инцидент: инциденту
читать: читайте
прекращение: прекращения
огонь: огня
каждый: каждый
деть: день
приносить: приносить
трагедия: трагедии
параллельно: параллельно
выражение: выражения
трансляция: трансляций
аль-джазира: аль-джазиры
запрет: запреты
критика: критики
администрация: администрации
социальный: социальных
сеть: сетях
арест: аресты
активист: активистов
переохлаждение: переохлаждения
юнисеф: юнисеф
первое: первые
семь: семь
день: дней
жертва: жертвами
массовый: массовых
ночное: ночные
удар: удары
хан-юнису: хан-юнису
аль-маваси: аль-маваси
представлять: представляет
отсутствие: отсутствие
адекватный: адекватного
жилье: жилья
сочетание: сочетании
зимний: зимними зимние
температура: температурами
миллион: миллиона
жить: живут
импровизированный: импровизированных
палатка: палатках
сообщаться: сообщается
младенец: младенцев
новорожденная: новорожденных новорожденные
гипотермия: гипотермии
маленький: маленьких
нехватка: нехватка
питание: питания
суровый: суровые
условие: условия
подвергать: подвергают
опасность: опасности
особенно: особенно
уязвимый: уязвимы
сопутствовать: сопутствующими
заболевание: заболеваниями
исполнительный: исполнительный
директор: директор
кэтрин: кэтрин
рассел: рассел
необходимо: необходимо
немедленно: немедленно
прекратить: прекратить
помочь: помочь
пострадать: пострадавшим
освободить: освободить
заложник: заложников
подписываться: подписывайтесь
наш: нашу наши
рассылка: рассылку
загружать: загружайте
приложение: приложение
мобильный: мобильных
устройство: устройств
срочный: срочных
потерять: потеряно
целый: целое
поколение: поколение
дегуманизация: дегуманизация
углубление: углубление
наступление: наступление
рафа: рафах
иметь: иметь
катастрофический: катастрофические
последствие: последствия
ресурс: ресурсы
информация: информация
партнер: партнеров
новостной: новостные
анонс: анонсы
журнал: журнал
заседание: заседаниях
аудиовизуальный: аудиовизуальные
материал: материалы
общение: общение
твиттер: твиттер
главное: главные
брифинг: брифингов
стенограмма: стенограммы
комментарий: комментарии
интернет: интернете
фейсбук: фейсбук
вконтакте: вконтакте
контакт: контакты
пользоваться: пользоваться
сайт: сайтом
указатель: указатель
часто: часто
задавать: задаваемые
вопрос: вопросы
остерегаться: остерегайтесь
мошенничество: мошенничества
конфиденциальность: конфиденциальность
пользование: пользования
пожертвование: пожертвования