воз: воз
медик: медики
ливан: ливане ливана ливан
сталкиваться: сталкиваются
серьезный: серьезными серьезное
угроза: угрозами
ход: ходе
свой: своей
работа: работы работу
новость: новости
оон: оон
перейти: перейти
основное: основному
добро: добро
пожаловать: пожаловать
русский: русский
другой: другие
глобальный: глобальный
взгляд: взгляд
человеческий: человеческие
судьба: судьбы
поиск: поиск
расширить: расширенный
язык: язык
меню: меню
главный: главная
азия: азия
америка: америка
африка: африка
ближний: ближний ближнем
восток: восток востоке
европа: европа
тема: темы теме
гуманитарный: гуманитарная гуманитарного
помощь: помощь помощи
беженец: беженцы
мигрант: мигранты
женщина: женщины
здравоохранение: здравоохранение здравоохранения
климат: климат
окружать: окружающая
среда: среда
культура: культура
образование: образование
международный: международное международного международной
правый: право права
мир: мир
безопасность: безопасность
генеральный: генеральный генерального
секретарить: секретарь секретаря
человек: человека людей
цель: цели целях
устойчивый: устойчивого
развитие: развития развитие
экономический: экономическое
подробный: подробнее
интервью: интервью
сюжет: сюжеты
экспресс-новости: экспресс-новости
фоторепортаж: фоторепортажи
пресс-секретарь: пресс-секретарь
выступление: выступления
заявление: заявления заявлению
пресса: прессой
официальный: официальные
поездка: поездки
фотография: фотографии
пресс-релиз: пресс-релизы
группа: группа
аккредитация: аккредитации
сми: сми
интернет-трансляция: интернет-трансляция
аудиотека: аудиотека
подписаться: подписаться
увкбхборразас: увкбхборразас
удар: удар
пригород: пригороде
бейрут: бейрута
ноябрь: ноября
год: года годы
печать: печать
половина: половина
нападение: нападений нападениях нападение нападения
объект: объекты
система: системы системой система
приводить: приводит
гибель: гибели гибель
медицинский: медицинских медицинские медицинского медицинской медицинская
работник: работников работника
пациент: пациентов пациента пациенты
показатель: показатель
высокий: выше
любой: любом любых
друг: другом
активный: активном
конфликт: конфликте
включать: включая
боевой: боевые
действие: действия действий
газ: газе газы газа
украина: украине украину
сообщать: сообщают
сегодня: сегодня
всемирный: всемирной
организация: организации
дать: данным
отслеживание: отслеживанию
учреждение: учреждения учреждений
состояние: состоянию
октябрь: октября
процент: процентов процента
такой: таких
атака: атак
привести: привели
сравнение: сравнения
среднемировой: среднемировой
составлять: составляет
информация: информации информация
страна: стран страны страна
территория: территорий территории
сообщить: сообщивших сообщили
период: период
судан: судан
оккупировать: оккупированные
палестинский: палестинские
опт: опт
случай: случае
общий: общего общей
число: числа
подобный: подобных
инцидент: инцидентов
крайний: крайней
мера: мере
один: одного одни одна
должен: должно должна
защита: защитой
погибнуть: погибли
получить: получили полученные
ранение: ранения
зафиксировать: зафиксировано
сложность: сложности
израиль: израиле
палестина: палестине
цифра: цифры
демонстрировать: демонстрируют
чрезвычайный: чрезвычайно
тревожный: тревожную
тенденция: тенденцию
очевидно: очевидно
лишение: лишение
гражданский: гражданских
лицо: лиц
доступ: доступа
жизненно: жизненно
важный: важной
преследование: преследование
являться: является
нарушение: нарушением
закон: закон
запрещать: запрещает
использование: использование
военный: военных военной военное
это: это
происходить: происходит
строгий: строгие
править: правила
обязательный: обязательные
предупреждение: предупреждения
ожидание: ожидания
заявить: заявил заявили
представитель: представитель представители
абдинасир: абдинасир
абубакар: абубакар
жертва: жертвы
результат: результате
большинство: большинства
зарегистрировать: зарегистрированных
пострадать: пострадали пострадала
масштабный: масштабнее
потеря: потери
слабый: слабее
способность: способность
восстановиться: восстановиться
кризис: кризиса кризисов кризис
долгосрочный: долгосрочной долгосрочных
перспектива: перспективе
подчеркивать: подчеркивают
читать: читайте
также: также
юнисеф: юнисеф
ребенок: детям дети
грозить: грозит
участь: участь
двойной: двойной
во-первых: во-первых
сам: сама
разрушение: разрушение
больница: больниц больница
трагедия: трагедией
во-вторых: во-вторых
последующий: последующие
неделя: недели неделю
месяц: месяцы
раненый: раненые ранены
страдать: страдающие
хронический: хроническими
заболевание: заболеваниями заболеваний
проходить: проходят
лечение: лечение
получать: получают
прививка: прививки
мочь: могут
передать: передать
масштаб: масштаб
последствие: последствий
отсутствие: отсутствия
услуга: услугам
охрана: охране
материнский: материнского
сексуальный: сексуального
репродуктивный: репродуктивного
здоровье: здоровья
диагностирование: диагностированию
излечимый: излечимых
сказать: сказал
каждый: каждая
десятая: десятая
довольный: довольно
развить: развитой
который: которая
сильный: сильно
многочисленный: многочисленных
последний: последние
отмечать: отмечают
испытывать: испытывает
давление: давление
прекратить: прекратили
функционировать: функционируют
лишь: лишь
частично: частично
например: например
набатия: набатия
провинция: провинций
потерять: потеряла
свое: своих
больничный: больничных
койка: коек
четыре: четыре
миротворец: миротворца миротворцев
временной: временных
сила: сил
всоонл: всоонл
пятница: пятницу
ранее: ранее
два: две
ракета: ракеты
попасть: попали
штаб: штаб
западный: западного
сектор: сектора
шаме: шаме
италия: италии
миссия: миссии
госпиталь: госпитале
счастье: счастью
травма: травмы
угрожать: угрожают
жизнь: жизни
добавить: добавили
вероятно: вероятно
выпустить: выпущенные
хезболлой: хезболлой
связанный: связанными
группировка: группировками
бункер: бункер
логистический: логистическую
зона: зону
использовать: используемую
полиция: полицией
причинить: причинив
значительный: значительный
ущерб: ущерб
близлежащий: близлежащей
инфраструктура: инфраструктуре
третье: третье
баз: базу
настоятельно: настоятельно
призывать: призывает
сторона: стороны
избегать: избегать
боев: боевых
вблизи: вблизи
миротворческий: миротворческих миротворческие
позиция: позиций
неприкосновенность: неприкосновенность
помещение: помещений
персонал: персонала
объединить: объединенных
нация: наций
соблюдаться: соблюдаться
обстоятельство: обстоятельствах
подписываться: подписывайтесь
наш: нашу наши
рассылка: рассылку
загружать: загружайте
приложение: приложение
мобильный: мобильных
устройство: устройств
израильский: израильская
армия: армия
преднамеренно: преднамеренно
снести: снесла
юг: юге
управление: управлении
право: правам
осуждать: осуждают
эскалация: эскалацию
насилие: насилия
глава: глава
событие: событиях
представлять: представлять
себя: собой
преступление: преступление
ресурс: ресурсы
партнер: партнеров
новостной: новостные
анонс: анонсы
журнал: журнал
отчет: отчеты
заседание: заседаниях
аудиовизуальный: аудиовизуальные
материал: материалы
общение: общение
твиттер: твиттер
главное: главные
брифинг: брифингов
стенограмма: стенограммы
комментарий: комментарии
журналист: журналистов
интернет: интернете
фейсбук: фейсбук
вконтакте: вконтакте
контакт: контакты
пользоваться: пользоваться
сайт: сайтом
указатель: указатель
часто: часто
задавать: задаваемые
вопрос: вопросы
остерегаться: остерегайтесь
мошенничество: мошенничества
конфиденциальность: конфиденциальность
условие: условия
пользование: пользования
пожертвование: пожертвования