газ: газе газа
успешный: успешно
завершиться: завершилась завершился
кампания: кампания кампании кампанию
вакцинация: вакцинации
полиомиелит: полиомиелита
новость: новости новостей
оон: оон
перейти: перейти
основное: основному основным
добро: добро
пожаловать: пожаловать
русский: русский
другой: другие
глобальный: глобальный
взгляд: взгляд
человеческий: человеческие
судьба: судьбы
поиск: поиск
расширить: расширенный
язык: язык
меню: меню
главный: главная
азия: азия
америка: америка
африка: африка
ближний: ближний
восток: восток
европа: европа
тема: темы теме
гуманитарный: гуманитарная гуманитарным гуманитарные гуманитарной
помощь: помощь помощи
беженец: беженцы беженцев беженцам
мигрант: мигранты
женщина: женщины
здравоохранение: здравоохранение здравоохранения
климат: климат
окружать: окружающая
среда: среда
культура: культура
образование: образование
международный: международное
правый: право права
мир: мир миру
безопасность: безопасность безопасности
генеральный: генеральный генерального
секретарить: секретарь секретаря
человек: человека
цель: цели
устойчивый: устойчивого
развитие: развития развитие
экономический: экономическое экономический
подробный: подробнее
интервью: интервью
сюжет: сюжеты
экспресс-новости: экспресс-новости
фоторепортаж: фоторепортажи
пресс-секретарь: пресс-секретарь
выступление: выступления
заявление: заявления
пресса: прессой
официальный: официальные
поездка: поездки
фотография: фотографии
пресс-релиз: пресс-релизы
группа: группа
аккредитация: аккредитации
сми: сми
интернет-трансляция: интернет-трансляция
аудиотека: аудиотека
подписаться: подписаться
фото: фото
служба: службы
вакцинировать: вакцинировали
процент: процентов
ребенок: детей
возраст: возрасте
год: лет
печать: печать
сентябрь: сентября
сектор: секторе
первый: первый
раунд: раунд
агентство: агентство агентства
оказание: оказанию оказание
палестинец: палестинцам
бапор: бапор
всемирный: всемирная
организация: организация организациям
воз: воз
партнер: партнеры партнеров
тысяча: тысяч
такой: таким
образ: образом
удаться: удалось
достигнуть: достичь
наметить: намеченной
привить: привить
порядок: порядка
анклав: анклаве анклава
следующий: следующий
шаг: шаг
предоставление: предоставление
второй: второй
доза: дозы
вакцина: вакцины
несколько: несколько
неделя: недель недели
восхищаться: восхищаемся
все: всеми
медицинский: медицинскими
бригада: бригадами
который: которые
провести: провели
сложный: сложную
операция: операцию операции операций
сказать: сказал
глава: глава
тедрос: тедрос
адханом: адханом
гебрейесус: гебрейесус
глубоко: глубоко
признательный: признательны
семья: семьям
доверие: доверие
сотрудничество: сотрудничество
добавить: добавил
директор: директор
назвать: назвал
огромный: огромным
успех: успехом
фон: фоне
трагический: трагической
повседневный: повседневной
реальность: реальности
проводиться: проводилась
этап: этапа
рассчитать: рассчитанные
центральный: центральные
южный: южные
северный: северные
район: районы районах
договоренность: договоренности
израиль: израилем израиль
период: период
объявить: объявлены
пауза: паузы пауз
день: дня
каждый: каждая каждый
ход: ходе
боевой: боевые
действие: действия
соответствующий: соответствующих
приостанавливаться: приостанавливались
часы: часов
деть: день
представить: представьте
условие: условиях условия
прекращение: прекращения
огонь: огня
гибель: гибель гибели
сотрудник: сотрудника сотрудники сотрудников
западный: западном западного западный
беречь: берегу берег
скорбеть: скорбят
связь: связи
смерть: смертью
свое: своего
коллега: коллеги
убить: убитого
минувший: минувшей
ночь: ночью
лагер: лагере
эль-фара: эль-фара
суфьян: суфьян
джабер: джабер
абед: абед
джавад: джавад
застрелить: застрелен
крыша: крыше
дома: дома
снайпер: снайпером
время: время
израильский: израильской израильских
военный: военной военных
санитарный: санитарным
работник: работником
остаться: остались
жена: жена
пятеро: пятеро
это: это
случай: случай
инцидент: инцидент
произойти: произошел
беспрецедентный: беспрецедентного
всплеск: всплеска
насилие: насилия насилию
берег: берега
пережить: пережили
затяжной: затяжных
большой: наибольшей
степень: степени
пострадать: пострадали
лагерь: лагеря
тулькарм: тулькарм
нур-шамс: нур-шамс
дженин: дженин
разрушить: разрушена
гражданский: гражданская гражданские
инфраструктура: инфраструктура
включать: включая
сеть: сети
водоснабжение: водоснабжения
электроснабжение: электроснабжения
также: также
отмечать: отмечают
эскалация: эскалации
мочь: могут
посещать: посещать
школа: школу
вынудить: вынуждены
приостановить: приостановить
соображение: соображений
выражать: выражают
обеспокоенность: обеспокоенность
использование: использованием
самодельный: самодельных
взрывной: взрывных
устройство: устройств
палестинский: палестинскими
вооруженный: вооруженными
формирование: формированиями
лицо: лица
должен: должны должен
защитить: защищены
обеспечить: обеспечен
безопасный: безопасный
доступ: доступ
услуга: услугам
заявить: заявил
роланда: роланд
фридрих: фридрих
отделение: отделения
нехватка: нехватка
инвалидный: инвалидных
коляска: колясок
кризис: кризис
подписываться: подписывайтесь
наш: нашу наши
рассылка: рассылку
загружать: загружайте
приложение: приложение
мобильный: мобильных
спецкоординатор: спецкоординатор
предупреждать: предупреждает
катастрофа: катастрофе
призывать: призывает
совбез: совбез
обсуждать: обсуждает
охватить: охватившему
регион: регион
видно: видно
конец: конца
продолжать: продолжает
оказывать: оказывать
расти: растут
масштаб: масштабы
разрушенье: разрушений
ресурс: ресурсы
информация: информация
новостной: новостные
анонс: анонсы
журнал: журнал
отчет: отчеты
заседание: заседаниях
аудиовизуальный: аудиовизуальные
материал: материалы
общение: общение
твиттер: твиттер
последний: последние
главное: главные
брифинг: брифингов
стенограмма: стенограммы
комментарий: комментарии
журналист: журналистов
интернет: интернете
фейсбук: фейсбук
вконтакте: вконтакте
контакт: контакты
пользоваться: пользоваться
сайт: сайтом
указатель: указатель
часто: часто
задавать: задаваемые
вопрос: вопросы
остерегаться: остерегайтесь
мошенничество: мошенничества
конфиденциальность: конфиденциальность
пользование: пользования
пожертвование: пожертвования